geo_id,name,total,hascomputer,dialup,broadband,nointernet,nocomputer
0500000US28151,"Washington County, Mississippi",18299,13858,31,11206,2621,4441
0500000US28111,"Perry County, Mississippi",4563,3552,33,2918,601,1011
0500000US28019,"Choctaw County, Mississippi",3164,2345,23,1765,557,819
0500000US28057,"Itawamba County, Mississippi",8706,7103,55,6005,1043,1603
0500000US28015,"Carroll County, Mississippi",3658,2813,29,2247,537,845
0500000US28043,"Grenada County, Mississippi",8224,6524,19,5183,1322,1700
0500000US28063,"Jefferson County, Mississippi",2530,1700,9,1503,188,830
0500000US28041,"Greene County, Mississippi",4172,3310,15,2757,538,862
0500000US28093,"Marshall County, Mississippi",13074,10429,186,7152,3091,2645
0500000US28119,"Quitman County, Mississippi",3055,2140,8,1581,551,915
0500000US28011,"Bolivar County, Mississippi",12159,8995,30,6983,1982,3164
0500000US28073,"Lamar County, Mississippi",22213,20259,113,17947,2199,1954
0500000US28081,"Lee County, Mississippi",32267,26950,122,23240,3588,5317
0500000US28113,"Pike County, Mississippi",14676,10570,31,7350,3189,4106
0500000US28135,"Tallahatchie County, Mississippi",4253,2915,33,2021,861,1338
0500000US28129,"Smith County, Mississippi",5872,4538,46,2849,1643,1334
0500000US28131,"Stone County, Mississippi",6135,4973,61,4224,688,1162
0500000US28149,"Warren County, Mississippi",18766,15177,146,13271,1760,3589
0500000US28023,"Clarke County, Mississippi",6258,4632,40,3500,1092,1626
0500000US28069,"Kemper County, Mississippi",3710,2450,13,1621,816,1260
0500000US28097,"Montgomery County, Mississippi",4619,3433,37,2839,557,1186
0500000US28105,"Oktibbeha County, Mississippi",17687,15345,124,12882,2339,2342
0500000US28109,"Pearl River County, Mississippi",20752,17914,125,14884,2905,2838
0500000US28079,"Leake County, Mississippi",8168,5925,15,4395,1515,2243
0500000US28103,"Noxubee County, Mississippi",4020,2820,5,2024,791,1200
0500000US28099,"Neshoba County, Mississippi",10699,8513,76,6535,1902,2186
0500000US28121,"Rankin County, Mississippi",55595,50047,146,44591,5310,5548
0500000US28137,"Tate County, Mississippi",10264,8396,87,6894,1415,1868
0500000US28077,"Lawrence County, Mississippi",4793,3379,45,2035,1299,1414
0500000US28107,"Panola County, Mississippi",12447,9298,150,6527,2621,3149
0500000US28161,"Yalobusha County, Mississippi",5161,3762,14,2613,1135,1399
0500000US28017,"Chickasaw County, Mississippi",6426,4533,8,3491,1034,1893
0500000US28029,"Copiah County, Mississippi",9623,6738,41,4198,2499,2885
0500000US28039,"George County, Mississippi",7362,5634,24,4609,1001,1728
0500000US28049,"Hinds County, Mississippi",88705,75265,190,64696,10379,13440
0500000US28101,"Newton County, Mississippi",8042,6338,24,4821,1493,1704
0500000US28145,"Union County, Mississippi",9951,7865,46,6387,1432,2086
0500000US28125,"Sharkey County, Mississippi",1755,1218,0,1081,137,537
0500000US28139,"Tippah County, Mississippi",7983,6256,36,4748,1472,1727
0500000US28035,"Forrest County, Mississippi",28033,23901,91,20146,3664,4132
0500000US28045,"Hancock County, Mississippi",19519,16805,24,14512,2269,2714
0500000US28071,"Lafayette County, Mississippi",19317,17490,31,15184,2275,1827
0500000US28055,"Issaquena County, Mississippi",484,296,0,238,58,188
0500000US28087,"Lowndes County, Mississippi",22742,19003,59,15655,3289,3739
0500000US28083,"Leflore County, Mississippi",10224,6209,44,4053,2112,4015
0500000US28157,"Wilkinson County, Mississippi",2898,1930,7,1373,550,968
0500000US28047,"Harrison County, Mississippi",78863,66891,223,60210,6458,11972
0500000US28065,"Jefferson Davis County, Mississippi",4839,3208,38,2002,1168,1631
0500000US28085,"Lincoln County, Mississippi",12827,9564,66,7133,2365,3263
0500000US28123,"Scott County, Mississippi",10435,7726,24,5558,2144,2709
0500000US28159,"Winston County, Mississippi",7396,5550,55,4400,1095,1846
0500000US28163,"Yazoo County, Mississippi",8689,6178,28,4953,1197,2511
0500000US28009,"Benton County, Mississippi",3033,2371,8,1647,716,662
0500000US28037,"Franklin County, Mississippi",3004,2428,43,2089,296,576
0500000US28061,"Jasper County, Mississippi",6690,4866,106,2987,1773,1824
0500000US28067,"Jones County, Mississippi",24774,19718,298,12970,6450,5056
0500000US28095,"Monroe County, Mississippi",14043,10551,75,8802,1674,3492
0500000US28133,"Sunflower County, Mississippi",8389,6430,69,4728,1633,1959
0500000US28155,"Webster County, Mississippi",3787,3025,6,2550,469,762
0500000US28001,"Adams County, Mississippi",11341,8780,33,7804,943,2561
0500000US28025,"Clay County, Mississippi",7755,5971,0,5153,818,1784
0500000US28031,"Covington County, Mississippi",6794,5435,145,3673,1617,1359
0500000US28053,"Humphreys County, Mississippi",3171,2402,6,1921,475,769
0500000US29195,"Saline County, Missouri",8562,7055,72,6217,766,1507
0500000US29123,"Madison County, Missouri",5002,3899,15,3252,632,1103
0500000US29229,"Wright County, Missouri",7292,5679,68,4665,946,1613
0500000US29217,"Vernon County, Missouri",8170,7041,109,6116,816,1129
0500000US29147,"Nodaway County, Missouri",8275,7353,136,6302,915,922
0500000US29041,"Chariton County, Missouri",2779,2149,10,1920,219,630
0500000US29079,"Grundy County, Missouri",3985,3140,34,2778,328,845
0500000US29141,"Morgan County, Missouri",7755,6075,81,4789,1205,1680
0500000US29223,"Wayne County, Missouri",5448,4104,21,3593,490,1344
0500000US29017,"Bollinger County, Missouri",4669,3715,43,3116,556,954
0500000US29031,"Cape Girardeau County, Missouri",29366,25929,202,23480,2247,3437
0500000US29205,"Shelby County, Missouri",2459,2013,13,1753,247,446
0500000US29225,"Webster County, Missouri",13496,11144,134,9044,1966,2352
0500000US29005,"Atchison County, Missouri",2505,2051,5,1819,227,454
0500000US29013,"Bates County, Missouri",6706,5617,62,4598,957,1089
0500000US29015,"Benton County, Missouri",7947,6366,82,5257,1027,1581
0500000US29035,"Carter County, Missouri",2366,1860,8,1466,386,506
0500000US29057,"Dade County, Missouri",3117,2486,37,2099,350,631
0500000US29115,"Linn County, Missouri",5068,4051,25,3429,597,1017
0500000US29091,"Howell County, Missouri",15922,13154,180,10759,2215,2768
0500000US29101,"Johnson County, Missouri",19939,18403,50,16900,1453,1536
0500000US29105,"Laclede County, Missouri",13866,11476,161,9356,1959,2390
0500000US29125,"Maries County, Missouri",3645,2718,59,2263,396,927
0500000US29161,"Phelps County, Missouri",17601,15416,101,13743,1572,2185
0500000US29165,"Platte County, Missouri",38613,36583,136,34273,2174,2030
0500000US29187,"St. Francois County, Missouri",24910,20492,116,18610,1766,4418
0500000US29003,"Andrew County, Missouri",6807,5856,90,5125,641,951
0500000US29033,"Carroll County, Missouri",3552,2868,40,2344,484,684
0500000US29061,"Daviess County, Missouri",2991,2391,61,2136,194,600
0500000US29103,"Knox County, Missouri",1533,1195,16,925,254,338
0500000US29127,"Marion County, Missouri",11500,9818,128,8658,1032,1682
0500000US29151,"Osage County, Missouri",5113,4143,27,3221,895,970
0500000US29181,"Ripley County, Missouri",5154,4001,21,3139,841,1153
0500000US29219,"Warren County, Missouri",12232,10546,119,9211,1216,1686
0500000US29007,"Audrain County, Missouri",9328,7461,94,6388,979,1867
0500000US29043,"Christian County, Missouri",31097,28529,127,24968,3434,2568
0500000US29077,"Greene County, Missouri",122026,107183,435,90906,15842,14843
0500000US29081,"Harrison County, Missouri",3556,2951,45,2611,295,605
0500000US29185,"St. Clair County, Missouri",4126,3151,37,2639,475,975
0500000US29001,"Adair County, Missouri",9513,8087,34,6717,1336,1426
0500000US29199,"Scotland County, Missouri",1820,1501,7,1297,197,319
0500000US29211,"Sullivan County, Missouri",2174,1641,31,1378,232,533
0500000US29045,"Clark County, Missouri",2942,2295,36,1970,289,647
0500000US29099,"Jefferson County, Missouri",84393,76260,420,68785,7055,8133
0500000US29111,"Lewis County, Missouri",3766,3099,78,2663,358,667
0500000US29143,"New Madrid County, Missouri",7312,5814,2,4968,844,1498
0500000US29157,"Perry County, Missouri",7605,6314,43,5755,516,1291
0500000US29173,"Ralls County, Missouri",4004,3351,37,3000,314,653
0500000US29177,"Ray County, Missouri",8785,7519,61,6471,987,1266
0500000US29189,"St. Louis County, Missouri",403547,365989,1527,338974,25488,37558
0500000US29209,"Stone County, Missouri",12841,11126,152,9797,1177,1715
0500000US29009,"Barry County, Missouri",13211,10905,81,8186,2638,2306
0500000US29019,"Boone County, Missouri",69957,65373,293,57501,7579,4584
0500000US29039,"Cedar County, Missouri",5785,4719,63,4070,586,1066
0500000US29055,"Crawford County, Missouri",9473,7309,136,6228,945,2164
0500000US29093,"Iron County, Missouri",4156,3169,28,2469,672,987
0500000US29117,"Livingston County, Missouri",5882,4817,30,3930,857,1065
0500000US29135,"Moniteau County, Missouri",5346,4251,81,3295,875,1095
0500000US29149,"Oregon County, Missouri",4307,3307,68,2245,994,1000
0500000US29069,"Dunklin County, Missouri",12427,9822,24,8624,1174,2605
0500000US29159,"Pettis County, Missouri",15921,13540,121,11651,1768,2381
0500000US29186,"Ste. Genevieve County, Missouri",7134,5928,74,5029,825,1206
0500000US29175,"Randolph County, Missouri",8347,6901,45,6179,677,1446
0500000US29071,"Franklin County, Missouri",40780,35718,356,30824,4538,5062
0500000US29089,"Howard County, Missouri",3559,2911,52,2523,336,648
0500000US29095,"Jackson County, Missouri",282653,246886,989,219926,25971,35767
0500000US29131,"Miller County, Missouri",9804,8122,88,6493,1541,1682
0500000US29169,"Pulaski County, Missouri",15026,13406,121,11778,1507,1620
0500000US29171,"Putnam County, Missouri",1803,1467,17,1119,331,336
0500000US29213,"Taney County, Missouri",22366,19832,207,17101,2524,2534
0500000US29215,"Texas County, Missouri",9579,7756,138,5888,1730,1823
0500000US29021,"Buchanan County, Missouri",33432,27864,134,24573,3157,5568
0500000US29025,"Caldwell County, Missouri",3682,2923,23,2537,363,759
0500000US29027,"Callaway County, Missouri",16038,13523,100,11313,2110,2515
0500000US29037,"Cass County, Missouri",39444,36132,191,32346,3595,3312
0500000US29049,"Clinton County, Missouri",8157,7087,47,6301,739,1070
0500000US29053,"Cooper County, Missouri",6428,5467,38,4658,771,961
0500000US29059,"Dallas County, Missouri",6253,4980,46,3922,1012,1273
0500000US29075,"Gentry County, Missouri",2601,2069,7,1875,187,532
0500000US29085,"Hickory County, Missouri",4020,3059,70,2580,409,961
0500000US29113,"Lincoln County, Missouri",18738,16592,175,14569,1848,2146
0500000US29133,"Mississippi County, Missouri",5040,3761,13,3271,477,1279
0500000US29137,"Monroe County, Missouri",3632,2848,27,2433,388,784
0500000US29145,"Newton County, Missouri",22268,18725,142,15501,3082,3543
0500000US29153,"Ozark County, Missouri",4144,3034,69,2436,529,1110
0500000US29163,"Pike County, Missouri",6650,5346,64,4556,726,1304
0500000US29183,"St. Charles County, Missouri",144643,136270,743,127293,8234,8373
0500000US30017,"Custer County, Montana",4889,4117,127,3605,385,772
0500000US30041,"Hill County, Montana",6274,5362,82,4660,620,912
0500000US30075,"Powder River County, Montana",769,690,47,577,66,79
0500000US30067,"Park County, Montana",7691,6691,73,6063,555,1000
0500000US30085,"Roosevelt County, Montana",3156,2323,2,2062,259,833
0500000US30005,"Blaine County, Montana",2320,1840,9,1499,332,480
0500000US30051,"Liberty County, Montana",886,729,0,615,114,157
0500000US30083,"Richland County, Montana",4493,3852,11,3386,455,641
0500000US30099,"Teton County, Montana",2475,2133,14,1794,325,342
0500000US30101,"Toole County, Montana",1898,1523,13,1319,191,375
0500000US30025,"Fallon County, Montana",1302,1139,0,1043,96,163
0500000US30019,"Daniels County, Montana",856,686,3,603,80,170
0500000US30045,"Judith Basin County, Montana",923,793,13,713,67,130
0500000US30093,"Silver Bow County, Montana",15158,12426,109,10663,1654,2732
0500000US30023,"Deer Lodge County, Montana",3855,3095,9,2750,336,760
0500000US30043,"Jefferson County, Montana",4444,3949,13,3495,441,495
0500000US30055,"McCone County, Montana",704,560,16,479,65,144
0500000US30107,"Wheatland County, Montana",821,676,2,564,110,145
0500000US30087,"Rosebud County, Montana",3147,2429,408,1678,343,718
0500000US30011,"Carter County, Montana",625,509,7,468,34,116
0500000US30021,"Dawson County, Montana",3972,3354,28,3025,301,618
0500000US30007,"Broadwater County, Montana",2420,2074,50,1680,344,346
0500000US30047,"Lake County, Montana",11849,10155,133,8515,1507,1694
0500000US30073,"Pondera County, Montana",2114,1747,6,1500,241,367
0500000US30111,"Yellowstone County, Montana",65025,58375,404,52770,5201,6650
0500000US30081,"Ravalli County, Montana",17108,15045,165,13082,1798,2063
0500000US30105,"Valley County, Montana",3436,2942,40,2510,392,494
0500000US30027,"Fergus County, Montana",4975,4288,106,3794,388,687
0500000US30061,"Mineral County, Montana",1699,1409,32,1101,276,290
0500000US30069,"Petroleum County, Montana",187,150,0,139,11,37
0500000US30089,"Sanders County, Montana",4953,3773,47,3345,381,1180
0500000US30029,"Flathead County, Montana",38252,33986,382,30963,2641,4266
0500000US30109,"Wibaux County, Montana",497,403,8,300,95,94
0500000US30059,"Meagher County, Montana",749,587,12,475,100,162
0500000US30009,"Carbon County, Montana",4531,3931,56,3446,429,600
0500000US30071,"Phillips County, Montana",1770,1407,28,1191,188,363
0500000US31001,"Adams County, Nebraska",12710,11052,116,9897,1039,1658
0500000US31109,"Lancaster County, Nebraska",122646,113258,388,104739,8131,9388
0500000US31011,"Boone County, Nebraska",2280,1921,21,1765,135,359
0500000US31149,"Rock County, Nebraska",626,512,7,438,67,114
0500000US31007,"Banner County, Nebraska",279,247,11,209,27,32
0500000US31163,"Sherman County, Nebraska",1358,1134,13,1011,110,224
0500000US31147,"Richardson County, Nebraska",3772,3142,21,2823,298,630
0500000US31093,"Howard County, Nebraska",2684,2268,45,1936,287,416
0500000US31089,"Holt County, Nebraska",4435,3761,51,3149,561,674
0500000US31065,"Furnas County, Nebraska",2142,1729,8,1552,169,413
0500000US31073,"Gosper County, Nebraska",877,744,5,686,53,133
0500000US31151,"Saline County, Nebraska",5073,4319,65,3807,447,754
0500000US31153,"Sarpy County, Nebraska",65045,61574,199,58327,3048,3471
0500000US31173,"Thurston County, Nebraska",2175,1747,25,1348,374,428
0500000US31177,"Washington County, Nebraska",8125,7460,130,6609,721,665
0500000US31015,"Boyd County, Nebraska",903,702,1,620,81,201
0500000US31031,"Cherry County, Nebraska",2566,2093,10,1901,182,473
0500000US31053,"Dodge County, Nebraska",15289,13266,121,11465,1680,2023
0500000US31059,"Fillmore County, Nebraska",2510,2078,28,1819,231,432
0500000US31069,"Garden County, Nebraska",871,768,6,629,133,103
0500000US31091,"Hooker County, Nebraska",319,242,0,213,29,77
0500000US31123,"Morrill County, Nebraska",1982,1669,7,1439,223,313
0500000US31127,"Nemaha County, Nebraska",2877,2471,45,2164,262,406
0500000US31159,"Seward County, Nebraska",6596,5808,57,5296,455,788
0500000US31171,"Thomas County, Nebraska",292,249,0,240,9,43
0500000US31043,"Dakota County, Nebraska",7456,6632,36,5594,1002,824
0500000US31181,"Webster County, Nebraska",1519,1255,30,1101,124,264
0500000US31003,"Antelope County, Nebraska",2675,2183,23,1914,246,492
0500000US31023,"Butler County, Nebraska",3377,2795,53,2497,245,582
0500000US31035,"Clay County, Nebraska",2574,2241,29,1938,274,333
0500000US31041,"Custer County, Nebraska",4846,4064,54,3385,625,782
0500000US31067,"Gage County, Nebraska",9160,7690,109,6950,631,1470
0500000US31081,"Hamilton County, Nebraska",3699,3372,39,3095,238,327
0500000US31099,"Kearney County, Nebraska",2682,2279,20,2080,179,403
0500000US31101,"Keith County, Nebraska",3844,3269,20,3040,209,575
0500000US31119,"Madison County, Nebraska",14254,12353,198,10808,1347,1901
0500000US31135,"Perkins County, Nebraska",1225,1069,7,1001,61,156
0500000US31155,"Saunders County, Nebraska",8326,7258,57,6523,678,1068
0500000US31179,"Wayne County, Nebraska",3657,3325,7,3088,230,332
0500000US31103,"Keya Paha County, Nebraska",326,271,4,246,21,55
0500000US31107,"Knox County, Nebraska",3674,3015,49,2620,346,659
0500000US31111,"Lincoln County, Nebraska",14985,13063,96,11639,1328,1922
0500000US31139,"Pierce County, Nebraska",3026,2617,34,2340,243,409
0500000US31165,"Sioux County, Nebraska",579,470,4,392,74,109
0500000US31025,"Cass County, Nebraska",10005,9160,76,8222,862,845
0500000US31051,"Dixon County, Nebraska",2311,1962,16,1666,280,349
0500000US31057,"Dundy County, Nebraska",865,712,3,608,101,153
0500000US31077,"Greeley County, Nebraska",1034,859,13,701,145,175
0500000US31079,"Hall County, Nebraska",22870,19590,199,17761,1630,3280
0500000US31131,"Otoe County, Nebraska",6452,5501,38,4942,521,951
0500000US31145,"Red Willow County, Nebraska",4459,3790,23,3296,471,669
0500000US31045,"Dawes County, Nebraska",3623,3095,24,2812,259,528
0500000US31033,"Cheyenne County, Nebraska",4434,3832,26,3322,484,602
0500000US31047,"Dawson County, Nebraska",8997,7787,60,6862,865,1210
0500000US31175,"Valley County, Nebraska",1840,1489,0,1302,187,351
0500000US31117,"McPherson County, Nebraska",203,161,0,118,43,42
0500000US31125,"Nance County, Nebraska",1546,1256,3,1141,112,290
0500000US31167,"Stanton County, Nebraska",2410,2123,53,1885,185,287
0500000US31083,"Harlan County, Nebraska",1521,1297,16,1158,123,224
0500000US31009,"Blaine County, Nebraska",218,193,0,173,20,25
0500000US31019,"Buffalo County, Nebraska",19165,17272,71,15643,1558,1893
0500000US31049,"Deuel County, Nebraska",824,706,7,571,128,118
0500000US31087,"Hitchcock County, Nebraska",1209,961,33,806,122,248
0500000US31141,"Platte County, Nebraska",13000,11198,96,9974,1128,1802
0500000US31169,"Thayer County, Nebraska",2283,1862,27,1685,150,421
0500000US31013,"Box Butte County, Nebraska",4801,4071,19,3696,356,730
0500000US32001,"Churchill County, Nevada",9819,8937,71,8055,811,882
0500000US32005,"Douglas County, Nevada",20579,18950,175,17609,1166,1629
0500000US32027,"Pershing County, Nevada",1933,1532,15,1355,162,401
0500000US32009,"Esmeralda County, Nevada",454,383,0,239,144,71
0500000US32013,"Humboldt County, Nevada",6271,5429,24,4847,558,842
0500000US32021,"Mineral County, Nevada",1938,1582,0,1341,241,356
0500000US32033,"White Pine County, Nevada",3529,3051,5,2767,279,478
0500000US32007,"Elko County, Nevada",17688,16297,80,14544,1673,1391
0500000US32017,"Lincoln County, Nevada",2041,1680,10,1550,120,361
0500000US32023,"Nye County, Nevada",18668,16349,233,13541,2575,2319
0500000US32029,"Storey County, Nevada",1598,1372,30,1258,84,226
0500000US32031,"Washoe County, Nevada",177632,162874,576,147202,15096,14758
0500000US32003,"Clark County, Nevada",767954,701851,3175,618385,80291,66103
0500000US32510,"Carson City, Nevada",22461,19864,53,17722,2089,2597
0500000US32019,"Lyon County, Nevada",20528,18315,62,16860,1393,2213
0500000US33005,"Cheshire County, New Hampshire",30319,27093,272,24684,2137,3226
0500000US33013,"Merrimack County, New Hampshire",57843,52749,303,49054,3392,5094
0500000US33009,"Grafton County, New Hampshire",34752,31609,296,28172,3141,3143
0500000US33015,"Rockingham County, New Hampshire",120147,113122,289,107636,5197,7025
0500000US33001,"Belknap County, New Hampshire",24739,22596,161,20715,1720,2143
0500000US33019,"Sullivan County, New Hampshire",17740,15714,83,14027,1604,2026
0500000US33011,"Hillsborough County, New Hampshire",159200,148553,608,139653,8292,10647
0500000US33017,"Strafford County, New Hampshire",48548,44779,197,40729,3853,3769
0500000US33007,"Coos County, New Hampshire",13720,11609,106,10143,1360,2111
0500000US33003,"Carroll County, New Hampshire",21070,19106,109,17667,1330,1964
0500000US34025,"Monmouth County, New Jersey",233874,215333,761,202773,11799,18541
0500000US34037,"Sussex County, New Jersey",53361,49771,319,46809,2643,3590
0500000US34011,"Cumberland County, New Jersey",50608,41837,217,36971,4649,8771
0500000US34013,"Essex County, New Jersey",282502,246794,874,218431,27489,35708
0500000US34029,"Ocean County, New Jersey",225270,197771,1134,180008,16629,27499
0500000US34015,"Gloucester County, New Jersey",104587,95878,303,89415,6160,8709
0500000US34033,"Salem County, New Jersey",23908,20456,243,18258,1955,3452
0500000US34031,"Passaic County, New Jersey",163670,139753,489,127119,12145,23917
0500000US34007,"Camden County, New Jersey",187158,166127,564,152285,13278,21031
0500000US34003,"Bergen County, New Jersey",338249,311587,966,297582,13039,26662
0500000US34041,"Warren County, New Jersey",41350,37319,242,34562,2515,4031
0500000US34017,"Hudson County, New Jersey",255429,229156,531,211182,17443,26273
0500000US34005,"Burlington County, New Jersey",165496,152552,683,143487,8382,12944
0500000US34027,"Morris County, New Jersey",180896,169565,471,162397,6697,11331
0500000US35039,"Rio Arriba County, New Mexico",12398,7747,55,6242,1450,4651
0500000US35047,"San Miguel County, New Mexico",11292,7767,3,5882,1882,3525
0500000US35057,"Torrance County, New Mexico",5664,4634,48,3503,1083,1030
0500000US35035,"Otero County, New Mexico",23391,19817,146,17556,2115,3574
0500000US35006,"Cibola County, New Mexico",8939,6834,117,4891,1826,2105
0500000US35019,"Guadalupe County, New Mexico",1404,712,8,539,165,692
0500000US35003,"Catron County, New Mexico",1381,946,0,708,238,435
0500000US35017,"Grant County, New Mexico",12003,9752,69,8015,1668,2251
0500000US35029,"Luna County, New Mexico",9025,6510,32,5103,1375,2515
0500000US35031,"McKinley County, New Mexico",20295,12016,255,8369,3392,8279
0500000US35055,"Taos County, New Mexico",12127,9438,157,7380,1901,2689
0500000US35007,"Colfax County, New Mexico",5678,4418,70,3690,658,1260
0500000US35015,"Eddy County, New Mexico",21264,18436,86,16487,1863,2828
0500000US35033,"Mora County, New Mexico",1535,920,2,769,149,615
0500000US35037,"Quay County, New Mexico",3060,2145,6,1735,404,915
0500000US35027,"Lincoln County, New Mexico",7815,6376,60,5389,927,1439
0500000US35025,"Lea County, New Mexico",22114,18767,42,16679,2046,3347
0500000US35049,"Santa Fe County, New Mexico",61972,53457,372,48330,4755,8515
0500000US35051,"Sierra County, New Mexico",5377,4105,38,3254,813,1272
0500000US35053,"Socorro County, New Mexico",4550,3007,59,2379,569,1543
0500000US35013,"Doña Ana County, New Mexico",77453,65676,274,54189,11213,11777
0500000US36095,"Schoharie County, New York",12559,10611,156,9055,1400,1948
0500000US36067,"Onondaga County, New York",185624,162450,556,144839,17055,23174
0500000US36019,"Clinton County, New York",31395,27528,104,24499,2925,3867
0500000US36099,"Seneca County, New York",13522,11631,92,10375,1164,1891
0500000US36079,"Putnam County, New York",34847,32874,47,31598,1229,1973
0500000US36033,"Franklin County, New York",19088,15636,133,13650,1853,3452
0500000US36069,"Ontario County, New York",44286,39633,252,36465,2916,4653
0500000US36081,"Queens County, New York",779234,691959,2010,632401,57548,87275
0500000US36101,"Steuben County, New York",40183,33846,409,29420,4017,6337
0500000US36041,"Hamilton County, New York",1124,932,12,807,113,192
0500000US36115,"Washington County, New York",24009,20688,230,18204,2254,3321
0500000US36013,"Chautauqua County, New York",52572,44089,447,38294,5348,8483
0500000US36047,"Kings County, New York",950856,815829,2929,727927,84973,135027
0500000US36061,"New York County, New York",758133,683361,1629,627026,54706,74772
0500000US36107,"Tioga County, New York",20045,17454,205,15892,1357,2591
0500000US36011,"Cayuga County, New York",31251,26754,201,23844,2709,4497
0500000US36073,"Orleans County, New York",16333,13940,127,12561,1252,2393
0500000US36091,"Saratoga County, New York",93876,86995,282,81939,4774,6881
0500000US36087,"Rockland County, New York",100005,87509,292,79817,7400,12496
0500000US36021,"Columbia County, New York",25243,22092,256,19270,2566,3151
0500000US36049,"Lewis County, New York",10242,8636,124,7654,858,1606
0500000US36063,"Niagara County, New York",88211,74207,980,66260,6967,14004
0500000US36119,"Westchester County, New York",347332,316547,761,292431,23355,30785
0500000US36025,"Delaware County, New York",19030,15843,118,13998,1727,3187
0500000US36031,"Essex County, New York",15425,13319,159,11729,1431,2106
0500000US36057,"Montgomery County, New York",19665,16183,189,14297,1697,3482
0500000US36059,"Nassau County, New York",445517,412702,964,392464,19274,32815
0500000US36085,"Richmond County, New York",166152,146693,590,133428,12675,19459
0500000US36097,"Schuyler County, New York",7304,6294,68,5490,736,1010
0500000US36109,"Tompkins County, New York",39326,36454,199,32772,3483,2872
0500000US36017,"Chenango County, New York",20616,17549,134,15642,1773,3067
0500000US36023,"Cortland County, New York",17685,15034,107,12611,2316,2651
0500000US36045,"Jefferson County, New York",43267,39033,164,35317,3552,4234
0500000US36065,"Oneida County, New York",90014,77432,514,69810,7108,12582
0500000US36103,"Suffolk County, New York",487981,447947,1241,420726,25980,40034
0500000US36121,"Wyoming County, New York",15815,13530,174,11902,1454,2285
0500000US36015,"Chemung County, New York",34373,30122,164,26511,3447,4251
0500000US36075,"Oswego County, New York",46032,41109,221,37342,3546,4923
0500000US36077,"Otsego County, New York",23556,20413,297,18026,2090,3143
0500000US36117,"Wayne County, New York",36504,31336,297,27655,3384,5168
0500000US36001,"Albany County, New York",126008,112036,400,102876,8760,13972
0500000US36007,"Broome County, New York",78594,68391,367,62097,5927,10203
0500000US36029,"Erie County, New York",387847,334516,1660,301620,31236,53331
0500000US36053,"Madison County, New York",26026,22573,114,20847,1612,3453
0500000US36105,"Sullivan County, New York",27890,23495,135,21607,1753,4395
0500000US37121,"Mitchell County, North Carolina",6361,4879,43,4224,612,1482
0500000US36037,"Genesee County, New York",23681,20281,100,18410,1771,3400
0500000US36071,"Orange County, New York",126776,112667,319,96393,15955,14109
0500000US37079,"Greene County, North Carolina",7259,6027,81,5196,750,1232
0500000US37041,"Chowan County, North Carolina",5984,4821,13,3933,875,1163
0500000US37027,"Caldwell County, North Carolina",32594,26685,259,24095,2331,5909
0500000US37035,"Catawba County, North Carolina",61099,52643,190,47872,4581,8456
0500000US37049,"Craven County, North Carolina",40871,36624,161,32828,3635,4247
0500000US37065,"Edgecombe County, North Carolina",21371,15910,84,12963,2863,5461
0500000US37085,"Harnett County, North Carolina",45086,40224,206,34181,5837,4862
0500000US37089,"Henderson County, North Carolina",48281,41971,169,38148,3654,6310
0500000US37095,"Hyde County, North Carolina",1769,1390,69,977,344,379
0500000US37119,"Mecklenburg County, North Carolina",403546,376743,830,347208,28705,26803
0500000US37131,"Northampton County, North Carolina",8628,6167,10,4324,1833,2461
0500000US37159,"Rowan County, North Carolina",52301,44818,308,39526,4984,7483
0500000US37181,"Vance County, North Carolina",16854,13386,83,10945,2358,3468
0500000US37053,"Currituck County, North Carolina",10148,9223,85,8122,1016,925
0500000US37179,"Union County, North Carolina",75165,70127,237,66683,3207,5038
0500000US37067,"Forsyth County, North Carolina",146685,129932,596,115799,13537,16753
0500000US37127,"Nash County, North Carolina",36720,30457,314,26776,3367,6263
0500000US37017,"Bladen County, North Carolina",13968,10854,90,8909,1855,3114
0500000US37055,"Dare County, North Carolina",15441,14538,59,13440,1039,903
0500000US37185,"Warren County, North Carolina",7780,5721,53,4288,1380,2059
0500000US37195,"Wilson County, North Carolina",32128,26397,124,23332,2941,5731
0500000US37015,"Bertie County, North Carolina",7976,5709,67,4380,1262,2267
0500000US37073,"Gates County, North Carolina",4477,3620,40,2964,616,857
0500000US37075,"Graham County, North Carolina",3288,2031,55,1624,352,1257
0500000US37117,"Martin County, North Carolina",9471,7524,48,5851,1625,1947
0500000US37115,"Madison County, North Carolina",8452,6846,42,5886,918,1606
0500000US37137,"Pamlico County, North Carolina",5352,4520,86,3679,755,832
0500000US37143,"Perquimans County, North Carolina",5919,4899,99,4091,709,1020
0500000US37149,"Polk County, North Carolina",9047,7813,122,6814,877,1234
0500000US37151,"Randolph County, North Carolina",56041,46499,358,39518,6623,9542
0500000US37157,"Rockingham County, North Carolina",37201,29401,189,25069,4143,7800
0500000US37169,"Stokes County, North Carolina",19302,15456,254,12834,2368,3846
0500000US37187,"Washington County, North Carolina",5073,3633,23,2885,725,1440
0500000US37029,"Camden County, North Carolina",3836,3415,28,3153,234,421
0500000US37043,"Clay County, North Carolina",5062,4397,29,3819,549,665
0500000US37051,"Cumberland County, North Carolina",124418,111378,375,100427,10576,13040
0500000US37071,"Gaston County, North Carolina",81494,69497,230,62521,6746,11997
0500000US37081,"Guilford County, North Carolina",202731,174779,627,146063,28089,27952
0500000US37099,"Jackson County, North Carolina",16642,13827,204,11054,2569,2815
0500000US37125,"Moore County, North Carolina",38965,33352,259,31165,1928,5613
0500000US37155,"Robeson County, North Carolina",45969,32950,78,24492,8380,13019
0500000US37167,"Stanly County, North Carolina",23717,20371,147,18209,2015,3346
0500000US37183,"Wake County, North Carolina",390498,372805,871,348941,22993,17693
0500000US37199,"Yancey County, North Carolina",7402,5533,12,4704,817,1869
0500000US37037,"Chatham County, North Carolina",28527,24971,198,21782,2991,3556
0500000US37111,"McDowell County, North Carolina",17961,14618,115,12443,2060,3343
0500000US37101,"Johnston County, North Carolina",67154,59875,420,50824,8631,7279
0500000US37103,"Jones County, North Carolina",4137,3095,70,2317,708,1042
0500000US37145,"Person County, North Carolina",15744,13002,75,11531,1396,2742
0500000US37019,"Brunswick County, North Carolina",54226,49290,343,43681,5266,4936
0500000US37009,"Ashe County, North Carolina",11805,9238,93,8076,1069,2567
0500000US37013,"Beaufort County, North Carolina",19325,15260,116,12520,2624,4065
0500000US37107,"Lenoir County, North Carolina",23121,18961,232,17053,1676,4160
0500000US37161,"Rutherford County, North Carolina",26345,20694,136,17371,3187,5651
0500000US37109,"Lincoln County, North Carolina",32022,27701,137,25104,2460,4321
0500000US37133,"Onslow County, North Carolina",64065,59747,192,54316,5239,4318
0500000US37135,"Orange County, North Carolina",52529,49118,260,45570,3288,3411
0500000US37163,"Sampson County, North Carolina",23537,18596,123,13836,4637,4941
0500000US37197,"Yadkin County, North Carolina",15448,12332,79,10506,1747,3116
0500000US37011,"Avery County, North Carolina",6587,5208,29,4331,848,1379
0500000US37023,"Burke County, North Carolina",34672,27322,262,23453,3607,7350
0500000US37033,"Caswell County, North Carolina",9110,6906,86,5632,1188,2204
0500000US37059,"Davie County, North Carolina",15999,13952,93,12845,1014,2047
0500000US37061,"Duplin County, North Carolina",21781,16900,89,13121,3690,4881
0500000US37063,"Durham County, North Carolina",123444,113335,296,104479,8560,10109
0500000US37105,"Lee County, North Carolina",21744,18283,121,15795,2367,3461
0500000US37129,"New Hanover County, North Carolina",93636,85251,228,76972,8051,8385
0500000US37191,"Wayne County, North Carolina",48153,40911,78,36147,4686,7242
0500000US37165,"Scotland County, North Carolina",13113,9828,93,7528,2207,3285
0500000US37083,"Halifax County, North Carolina",21116,15973,113,11837,4023,5143
0500000US37001,"Alamance County, North Carolina",64059,55693,239,48093,7361,8366
0500000US38013,"Burke County, North Dakota",877,742,3,598,141,135
0500000US38061,"Mountrail County, North Dakota",3235,2749,12,2174,563,486
0500000US38105,"Williams County, North Dakota",13695,12612,29,10209,2374,1083
0500000US38007,"Billings County, North Dakota",385,295,2,262,31,90
0500000US38043,"Kidder County, North Dakota",1055,857,3,694,160,198
0500000US38019,"Cavalier County, North Dakota",1737,1470,3,1370,97,267
0500000US38037,"Grant County, North Dakota",1094,855,8,745,102,239
0500000US38067,"Pembina County, North Dakota",3180,2546,17,2207,322,634
0500000US38091,"Steele County, North Dakota",891,781,3,666,112,110
0500000US38041,"Hettinger County, North Dakota",1079,863,0,773,90,216
0500000US38045,"LaMoure County, North Dakota",1813,1471,15,1303,153,342
0500000US38059,"Morton County, North Dakota",13536,12038,88,10636,1314,1498
0500000US38017,"Cass County, North Dakota",74205,68074,202,61845,6027,6131
0500000US38025,"Dunn County, North Dakota",1648,1409,2,1273,134,239
0500000US38029,"Emmons County, North Dakota",1556,1137,6,900,231,419
0500000US38051,"McIntosh County, North Dakota",1317,1046,6,879,161,271
0500000US38063,"Nelson County, North Dakota",1479,1203,5,990,208,276
0500000US38077,"Richland County, North Dakota",6760,5946,51,5269,626,814
0500000US38079,"Rolette County, North Dakota",4638,3610,18,2963,629,1028
0500000US38099,"Walsh County, North Dakota",4841,3911,17,3349,545,930
0500000US38001,"Adams County, North Dakota",1046,904,0,813,91,142
0500000US38009,"Bottineau County, North Dakota",3065,2654,10,2397,247,411
0500000US38003,"Barnes County, North Dakota",5085,4373,33,3835,505,712
0500000US38027,"Eddy County, North Dakota",1052,855,9,735,111,197
0500000US38035,"Grand Forks County, North Dakota",30215,27228,75,23780,3373,2987
0500000US38053,"McKenzie County, North Dakota",3899,3653,29,3189,435,246
0500000US38057,"Mercer County, North Dakota",3702,3235,5,2936,294,467
0500000US38055,"McLean County, North Dakota",4333,3807,16,3016,775,526
0500000US38069,"Pierce County, North Dakota",1937,1562,0,1452,110,375
0500000US38073,"Ransom County, North Dakota",2367,1980,15,1761,204,387
0500000US38085,"Sioux County, North Dakota",1110,750,23,590,137,360
0500000US38011,"Bowman County, North Dakota",1398,1257,2,1098,157,141
0500000US38033,"Golden Valley County, North Dakota",856,674,0,582,92,182
0500000US38047,"Logan County, North Dakota",883,740,0,610,130,143
0500000US38095,"Towner County, North Dakota",1036,828,6,674,148,208
0500000US38093,"Stutsman County, North Dakota",9055,7911,24,6727,1160,1144
0500000US38023,"Divide County, North Dakota",1119,908,0,627,281,211
0500000US38031,"Foster County, North Dakota",1440,1227,36,1074,117,213
0500000US38081,"Sargent County, North Dakota",1834,1608,19,1417,172,226
0500000US38087,"Slope County, North Dakota",329,257,6,239,12,72
0500000US38089,"Stark County, North Dakota",12150,10598,48,9345,1205,1552
0500000US39053,"Gallia County, Ohio",11662,9067,122,7467,1478,2595
0500000US39077,"Huron County, Ohio",22860,19833,242,17452,2139,3027
0500000US39009,"Athens County, Ohio",22620,19370,179,16284,2907,3250
0500000US39001,"Adams County, Ohio",10835,8045,192,6437,1416,2790
0500000US39103,"Medina County, Ohio",68121,62976,350,58592,4034,5145
0500000US39159,"Union County, Ohio",19546,17866,117,16815,934,1680
0500000US39021,"Champaign County, Ohio",15209,13580,84,12449,1047,1629
0500000US39125,"Paulding County, Ohio",7770,6441,76,5554,811,1329
0500000US39057,"Greene County, Ohio",65406,59644,122,54983,4539,5762
0500000US39049,"Franklin County, Ohio",504702,462243,1356,426507,34380,42459
0500000US39101,"Marion County, Ohio",24616,21179,131,18620,2428,3437
0500000US39115,"Morgan County, Ohio",6147,4876,195,4042,639,1271
0500000US39169,"Wayne County, Ohio",43385,36392,236,33384,2772,6993
0500000US39175,"Wyandot County, Ohio",9076,7745,47,6728,970,1331
0500000US39017,"Butler County, Ohio",138226,125178,420,116004,8754,13048
0500000US39067,"Harrison County, Ohio",6200,4872,67,4335,470,1328
0500000US39083,"Knox County, Ohio",23340,19865,211,17946,1708,3475
0500000US39139,"Richland County, Ohio",47998,40022,340,34982,4700,7976
0500000US39163,"Vinton County, Ohio",5111,3718,18,2856,844,1393
0500000US39063,"Hancock County, Ohio",31887,28690,234,26079,2377,3197
0500000US39045,"Fairfield County, Ohio",55748,50269,273,46009,3987,5479
0500000US39039,"Defiance County, Ohio",15213,13195,212,11904,1079,2018
0500000US39069,"Henry County, Ohio",11065,9800,96,8943,761,1265
0500000US39081,"Jefferson County, Ohio",27363,22068,96,19931,2041,5295
0500000US39137,"Putnam County, Ohio",13236,11742,93,10452,1197,1494
0500000US39027,"Clinton County, Ohio",16370,14162,143,12704,1315,2208
0500000US39047,"Fayette County, Ohio",11736,9855,33,8169,1653,1881
0500000US39129,"Pickaway County, Ohio",19728,17123,124,15609,1390,2605
0500000US39091,"Logan County, Ohio",18654,16321,120,14771,1430,2333
0500000US39153,"Summit County, Ohio",224385,195786,1076,178161,16549,28599
0500000US39143,"Sandusky County, Ohio",23562,20137,145,17411,2581,3425
0500000US39149,"Shelby County, Ohio",18643,16218,124,14466,1628,2425
0500000US27033,"Cottonwood County, Minnesota",4850,4031,47,3529,455,819
0500000US27139,"Scott County, Minnesota",48510,45903,198,43148,2557,2607
0500000US27039,"Dodge County, Minnesota",7711,7002,48,6525,429,709
0500000US27157,"Wabasha County, Minnesota",8841,7707,74,7073,560,1134
0500000US27117,"Pipestone County, Minnesota",4007,3336,37,2944,355,671
0500000US27035,"Crow Wing County, Minnesota",26684,23592,231,21493,1868,3092
0500000US27107,"Norman County, Minnesota",2776,2196,26,1794,376,580
0500000US27171,"Wright County, Minnesota",47246,43305,343,39905,3057,3941
0500000US27103,"Nicollet County, Minnesota",12738,11385,111,10478,796,1353
0500000US27041,"Douglas County, Minnesota",16395,14360,222,12460,1678,2035
0500000US27051,"Grant County, Minnesota",2600,2259,40,1910,309,341
0500000US27069,"Kittson County, Minnesota",1891,1560,33,1098,429,331
0500000US27079,"Le Sueur County, Minnesota",10874,9605,127,8480,998,1269
0500000US27087,"Mahnomen County, Minnesota",1938,1488,16,1257,215,450
0500000US27025,"Chisago County, Minnesota",20102,18241,132,16863,1246,1861
0500000US27127,"Redwood County, Minnesota",6240,5236,94,4310,832,1004
0500000US27173,"Yellow Medicine County, Minnesota",4165,3525,48,3109,368,640
0500000US27153,"Todd County, Minnesota",9841,7880,151,6761,968,1961
0500000US27007,"Beltrami County, Minnesota",17271,14956,54,13466,1436,2315
0500000US27013,"Blue Earth County, Minnesota",25783,23629,100,21654,1875,2154
0500000US27055,"Houston County, Minnesota",8181,7072,89,6523,460,1109
0500000US27073,"Lac qui Parle County, Minnesota",3103,2599,18,2345,236,504
0500000US27077,"Lake of the Woods County, Minnesota",1585,1295,10,722,563,290
0500000US27111,"Otter Tail County, Minnesota",24226,20632,314,17568,2750,3594
0500000US27161,"Waseca County, Minnesota",7427,6522,67,5954,501,905
0500000US27137,"St. Louis County, Minnesota",85644,73625,932,64976,7717,12019
0500000US27003,"Anoka County, Minnesota",126848,117633,998,110535,6100,9215
0500000US27145,"Stearns County, Minnesota",58891,53235,481,47179,5575,5656
0500000US27081,"Lincoln County, Minnesota",2470,1951,21,1687,243,519
0500000US27089,"Marshall County, Minnesota",3964,3328,110,2834,384,636
0500000US27095,"Mille Lacs County, Minnesota",10136,8553,79,7538,936,1583
0500000US27163,"Washington County, Minnesota",93184,87837,473,83678,3686,5347
0500000US27017,"Carlton County, Minnesota",13418,11415,158,9689,1568,2003
0500000US27065,"Kanabec County, Minnesota",6449,5441,49,4608,784,1008
0500000US27071,"Koochiching County, Minnesota",5566,4593,52,3956,585,973
0500000US27125,"Red Lake County, Minnesota",1691,1422,13,1250,159,269
0500000US27097,"Morrison County, Minnesota",13488,11157,135,9891,1131,2331
0500000US27131,"Rice County, Minnesota",23045,20282,191,18743,1348,2763
0500000US27147,"Steele County, Minnesota",14498,12701,73,11787,841,1797
0500000US27001,"Aitkin County, Minnesota",7713,6457,87,5429,941,1256
0500000US27043,"Faribault County, Minnesota",6115,5021,67,4394,560,1094
0500000US27101,"Murray County, Minnesota",3702,3151,42,2752,357,551
0500000US27067,"Kandiyohi County, Minnesota",16699,14747,99,13111,1537,1952
0500000US27075,"Lake County, Minnesota",5183,4544,96,4055,393,639
0500000US27133,"Rock County, Minnesota",3978,3496,24,3100,372,482
0500000US27143,"Sibley County, Minnesota",6038,5142,87,4387,668,896
0500000US27155,"Traverse County, Minnesota",1584,1341,14,1140,187,243
0500000US27005,"Becker County, Minnesota",13487,11616,137,10295,1184,1871
0500000US27053,"Hennepin County, Minnesota",503476,466438,2190,426498,37750,37038
0500000US27015,"Brown County, Minnesota",10731,9279,80,8348,851,1452
0500000US27023,"Chippewa County, Minnesota",5098,4266,151,3702,413,832
0500000US27029,"Clearwater County, Minnesota",3458,2794,29,2457,308,664
0500000US27057,"Hubbard County, Minnesota",8705,7639,108,6733,798,1066
0500000US27059,"Isanti County, Minnesota",14702,12984,185,11650,1149,1718
0500000US27091,"Martin County, Minnesota",8653,7289,107,6547,635,1364
0500000US27099,"Mower County, Minnesota",15502,13260,132,11876,1252,2242
0500000US27115,"Pine County, Minnesota",10690,8731,128,7310,1293,1959
0500000US27109,"Olmsted County, Minnesota",60770,56141,330,52151,3660,4629
0500000US27159,"Wadena County, Minnesota",5677,4550,63,4016,471,1127
0500000US27009,"Benton County, Minnesota",16217,14481,86,12919,1476,1736
0500000US27047,"Freeborn County, Minnesota",12970,11041,103,9627,1311,1929
0500000US27085,"McLeod County, Minnesota",14884,13132,128,12029,975,1752
0500000US27121,"Pope County, Minnesota",4972,4218,59,3619,540,754
0500000US27149,"Stevens County, Minnesota",3629,3162,27,2801,334,467
0500000US27151,"Swift County, Minnesota",4227,3443,48,3004,391,784
0500000US28051,"Holmes County, Mississippi",6269,3972,12,2371,1589,2297
0500000US28005,"Amite County, Mississippi",5003,3385,28,2699,658,1618
0500000US28013,"Calhoun County, Mississippi",5797,4226,69,3355,802,1571
0500000US28141,"Tishomingo County, Mississippi",7635,5934,53,4785,1096,1701
0500000US28153,"Wayne County, Mississippi",7734,6019,12,4713,1294,1715
0500000US48015,"Austin County, Texas",11041,9490,81,7794,1615,1551
0500000US48261,"Kenedy County, Texas",209,105,0,78,27,104
0500000US48355,"Nueces County, Texas",128926,112411,243,100656,11512,16515
0500000US48089,"Colorado County, Texas",7511,5816,54,4700,1062,1695
0500000US48409,"San Patricio County, Texas",23121,20030,18,15993,4019,3091
0500000US48379,"Rains County, Texas",4331,3639,17,3081,541,692
0500000US48381,"Randall County, Texas",49187,45972,187,42035,3750,3215
0500000US48385,"Real County, Texas",1227,962,9,764,189,265
0500000US48411,"San Saba County, Texas",2104,1679,18,1435,226,425
0500000US48413,"Schleicher County, Texas",1105,907,22,739,146,198
0500000US48431,"Sterling County, Texas",462,397,0,337,60,65
0500000US48507,"Zavala County, Texas",3509,2485,19,1662,804,1024
0500000US48057,"Calhoun County, Texas",7604,6644,13,5748,883,960
0500000US48065,"Carson County, Texas",2247,2015,18,1657,340,232
0500000US48155,"Foard County, Texas",557,464,5,372,87,93
0500000US48161,"Freestone County, Texas",6865,5496,65,4469,962,1369
0500000US48175,"Goliad County, Texas",2681,2038,42,1647,349,643
0500000US48193,"Hamilton County, Texas",3108,2564,28,2062,474,544
0500000US48197,"Hardeman County, Texas",1519,1203,8,984,211,316
0500000US48335,"Mitchell County, Texas",2441,1998,58,1642,298,443
0500000US48045,"Briscoe County, Texas",632,516,18,456,42,116
0500000US48285,"Lavaca County, Texas",7756,6080,58,5591,431,1676
0500000US48445,"Terry County, Texas",4041,3374,19,2642,713,667
0500000US48243,"Jeff Davis County, Texas",1050,946,0,689,257,104
0500000US48479,"Webb County, Texas",73659,56536,342,44903,11291,17123
0500000US48247,"Jim Hogg County, Texas",1710,1118,4,841,273,592
0500000US48339,"Montgomery County, Texas",192823,181070,702,168331,12037,11753
0500000US48111,"Dallam County, Texas",2404,1995,0,1741,254,409
0500000US48011,"Armstrong County, Texas",708,619,10,536,73,89
0500000US48069,"Castro County, Texas",2532,2033,36,1716,281,499
0500000US48273,"Kleberg County, Texas",10946,9504,31,7980,1493,1442
0500000US48489,"Willacy County, Texas",5810,4312,46,3088,1178,1498
0500000US48107,"Crosby County, Texas",2044,1636,26,1309,301,408
0500000US48151,"Fisher County, Texas",1649,1282,11,1106,165,367
0500000US48131,"Duval County, Texas",3511,2409,7,2041,361,1102
0500000US48031,"Blanco County, Texas",4297,3889,79,3443,367,408
0500000US48241,"Jasper County, Texas",12583,9884,67,7470,2347,2699
0500000US48271,"Kinney County, Texas",1170,847,0,636,211,323
0500000US48117,"Deaf Smith County, Texas",6139,5023,16,4551,456,1116
0500000US48167,"Galveston County, Texas",119181,107745,482,97530,9733,11436
0500000US48283,"La Salle County, Texas",2216,1672,0,1312,360,544
0500000US48393,"Roberts County, Texas",311,296,0,248,48,15
0500000US48457,"Tyler County, Texas",7020,5598,60,4423,1115,1422
0500000US48483,"Wheeler County, Texas",2254,2018,26,1657,335,236
0500000US48037,"Bowie County, Texas",33731,26209,205,22697,3307,7522
0500000US48043,"Brewster County, Texas",3942,3424,0,2963,461,518
0500000US48263,"Kent County, Texas",318,249,6,218,25,69
0500000US48423,"Smith County, Texas",77195,69001,204,61066,7731,8194
0500000US48105,"Crockett County, Texas",1388,1181,0,1005,176,207
0500000US48199,"Hardin County, Texas",20385,17778,64,15500,2214,2607
0500000US48227,"Howard County, Texas",11036,9496,48,7903,1545,1540
0500000US48289,"Leon County, Texas",6249,5172,79,4313,780,1077
0500000US48337,"Montague County, Texas",7995,6809,15,5494,1300,1186
0500000US48365,"Panola County, Texas",8827,7058,122,6062,874,1769
0500000US49027,"Millard County, Utah",4306,3990,32,3521,437,316
0500000US49053,"Washington County, Utah",54702,50730,357,46090,4283,3972
0500000US49025,"Kane County, Utah",2634,2375,17,2000,358,259
0500000US49019,"Grand County, Utah",4006,3700,21,3453,226,306
0500000US49033,"Rich County, Utah",620,579,29,471,79,41
0500000US49051,"Wasatch County, Utah",9567,9190,87,8560,543,377
0500000US49003,"Box Elder County, Utah",17302,15681,160,14201,1320,1621
0500000US49021,"Iron County, Utah",16204,15236,65,13539,1632,968
0500000US49041,"Sevier County, Utah",7261,6666,53,5854,759,595
0500000US49057,"Weber County, Utah",82417,76426,302,69250,6874,5991
0500000US49013,"Duchesne County, Utah",6644,5981,17,5461,503,663
0500000US49037,"San Juan County, Utah",3992,2595,59,2047,489,1397
0500000US49035,"Salt Lake County, Utah",369429,348912,1651,314382,32879,20517
0500000US49047,"Uintah County, Utah",10625,9490,92,8657,741,1135
0500000US49009,"Daggett County, Utah",145,143,2,134,7,2
0500000US49011,"Davis County, Utah",102865,98856,472,92542,5842,4009
0500000US49055,"Wayne County, Utah",1021,889,36,781,72,132
0500000US49007,"Carbon County, Utah",7844,6912,22,6104,786,932
0500000US49015,"Emery County, Utah",3589,3139,10,2786,343,450
0500000US49029,"Morgan County, Utah",3306,3189,24,3053,112,117
0500000US49005,"Cache County, Utah",37645,35888,87,32162,3639,1757
0500000US49017,"Garfield County, Utah",1741,1583,20,1365,198,158
0500000US49023,"Juab County, Utah",3390,3068,78,2622,368,322
0500000US50021,"Rutland County, Vermont",25145,21958,108,19485,2365,3187
0500000US50019,"Orleans County, Vermont",11679,9502,143,8469,890,2177
0500000US50013,"Grand Isle County, Vermont",2967,2710,29,2477,204,257
0500000US50017,"Orange County, Vermont",12286,10618,222,9433,963,1668
0500000US50007,"Chittenden County, Vermont",65400,60769,230,55508,5031,4631
0500000US50015,"Lamoille County, Vermont",10607,9677,106,8522,1049,930
0500000US50027,"Windsor County, Vermont",24310,21738,136,19589,2013,2572
0500000US50005,"Caledonia County, Vermont",12214,10375,144,8900,1331,1839
0500000US51185,"Tazewell County, Virginia",17042,13247,62,11861,1324,3795
0500000US50025,"Windham County, Vermont",19118,17046,195,14125,2726,2072
0500000US50001,"Addison County, Vermont",14733,13059,145,11788,1126,1674
0500000US50023,"Washington County, Vermont",24865,21850,124,19873,1853,3015
0500000US51610,"Falls Church city, Virginia",5262,5146,0,4909,237,116
0500000US51685,"Manassas Park city, Virginia",4706,4552,0,4187,365,154
0500000US51735,"Poquoson city, Virginia",4615,4215,0,3956,259,400
0500000US51183,"Sussex County, Virginia",3814,2971,7,2413,551,843
0500000US51820,"Waynesboro city, Virginia",9144,7756,35,6558,1163,1388
0500000US51770,"Roanoke city, Virginia",42037,35465,237,29883,5345,6572
0500000US51775,"Salem city, Virginia",9881,8802,23,7607,1172,1079
0500000US51710,"Norfolk city, Virginia",88155,79149,205,71278,7666,9006
0500000US51037,"Charlotte County, Virginia",4543,3054,117,2419,518,1489
0500000US51059,"Fairfax County, Virginia",394447,381273,1026,365617,14630,13174
0500000US51081,"Greensville County, Virginia",3688,2893,10,2275,608,795
0500000US51095,"James City County, Virginia",28766,26961,90,24644,2227,1805
0500000US51167,"Russell County, Virginia",10965,7609,99,6155,1355,3356
0500000US51173,"Smyth County, Virginia",12881,9973,153,8607,1213,2908
0500000US51678,"Lexington city, Virginia",1984,1596,0,1372,224,388
0500000US51031,"Campbell County, Virginia",22957,18679,236,16272,2171,4278
0500000US51089,"Henry County, Virginia",21598,17022,173,14253,2596,4576
0500000US51099,"King George County, Virginia",9103,8482,64,7818,600,621
0500000US51103,"Lancaster County, Virginia",5142,4236,48,3676,512,906
0500000US51105,"Lee County, Virginia",9149,6434,66,4356,2012,2715
0500000US51115,"Mathews County, Virginia",3908,3284,63,2755,466,624
0500000US51119,"Middlesex County, Virginia",4454,3631,44,2861,726,823
0500000US51149,"Prince George County, Virginia",11415,10197,39,8946,1212,1218
0500000US51165,"Rockingham County, Virginia",30946,25849,194,22617,3038,5097
0500000US51169,"Scott County, Virginia",8767,6384,66,5374,944,2383
0500000US51181,"Surry County, Virginia",2760,2375,43,1785,547,385
0500000US51011,"Appomattox County, Virginia",6095,4699,39,3965,695,1396
0500000US51067,"Franklin County, Virginia",23104,18756,292,15893,2571,4348
0500000US51097,"King and Queen County, Virginia",2826,2104,55,1595,454,722
0500000US51121,"Montgomery County, Virginia",35483,32642,80,30319,2243,2841
0500000US51127,"New Kent County, Virginia",7754,7123,86,6128,909,631
0500000US51049,"Cumberland County, Virginia",3963,3072,43,2280,749,891
0500000US51075,"Goochland County, Virginia",8426,7593,51,6811,731,833
0500000US51083,"Halifax County, Virginia",14025,9508,148,7640,1720,4517
0500000US51113,"Madison County, Virginia",5078,4256,119,3487,650,822
0500000US51153,"Prince William County, Virginia",140473,135892,333,130250,5309,4581
0500000US51175,"Southampton County, Virginia",6522,5672,90,4619,963,850
0500000US51091,"Highland County, Virginia",1123,897,8,822,67,226
0500000US51025,"Brunswick County, Virginia",6048,4605,38,3724,843,1443
0500000US51033,"Caroline County, Virginia",10911,9172,140,7449,1583,1739
0500000US51073,"Gloucester County, Virginia",14759,13112,80,11831,1201,1647
0500000US51131,"Northampton County, Virginia",5151,4062,30,3402,630,1089
0500000US51141,"Patrick County, Virginia",7685,5676,110,4812,754,2009
0500000US51145,"Powhatan County, Virginia",10178,9589,53,8869,667,589
0500000US51163,"Rockbridge County, Virginia",8979,7003,227,6213,563,1976
0500000US51171,"Shenandoah County, Virginia",17315,14190,169,12342,1679,3125
0500000US51061,"Fauquier County, Virginia",24333,22442,169,20992,1281,1891
0500000US51036,"Charles City County, Virginia",2856,2210,37,1702,471,646
0500000US51047,"Culpeper County, Virginia",16903,14702,221,13284,1197,2201
0500000US51053,"Dinwiddie County, Virginia",10391,8576,82,7245,1249,1815
0500000US51079,"Greene County, Virginia",7357,6652,27,5945,680,705
0500000US51085,"Hanover County, Virginia",38599,35771,214,32842,2715,2828
0500000US51111,"Lunenburg County, Virginia",4331,2931,79,2390,462,1400
0500000US51137,"Orange County, Virginia",13453,11937,81,10152,1704,1516
0500000US51660,"Harrisonburg city, Virginia",16768,14843,28,12277,2538,1925
0500000US51595,"Emporia city, Virginia",2119,1644,7,1320,317,475
0500000US51197,"Wythe County, Virginia",11955,9439,85,7993,1361,2516
0500000US51550,"Chesapeake city, Virginia",84230,78517,271,74280,3966,5713
0500000US51003,"Albemarle County, Virginia",40612,37723,273,34189,3261,2889
0500000US51019,"Bedford County, Virginia",31206,26533,336,23059,3138,4673
0500000US51023,"Botetourt County, Virginia",13161,11489,127,9955,1407,1672
0500000US51195,"Wise County, Virginia",15126,12129,101,9823,2205,2997
0500000US51520,"Bristol city, Virginia",7402,6071,26,5408,637,1331
0500000US51740,"Portsmouth city, Virginia",36471,31577,131,27451,3995,4894
0500000US51830,"Williamsburg city, Virginia",4670,4342,14,3974,354,328
0500000US51005,"Alleghany County, Virginia",6741,5342,46,4497,799,1399
0500000US51035,"Carroll County, Virginia",12375,9374,55,7975,1344,3001
0500000US51191,"Washington County, Virginia",22331,18459,220,16366,1873,3872
0500000US51133,"Northumberland County, Virginia",5686,4791,23,4156,612,895
0500000US51139,"Page County, Virginia",9338,7022,151,5851,1020,2316
0500000US51187,"Warren County, Virginia",14379,12885,155,11509,1221,1494
0500000US51510,"Alexandria city, Virginia",69979,66410,50,62544,3816,3569
0500000US51630,"Fredericksburg city, Virginia",10582,9777,29,8776,972,805
0500000US51650,"Hampton city, Virginia",53700,48569,155,42518,5896,5131
0500000US51013,"Arlington County, Virginia",104716,99554,384,94398,4772,5162
0500000US51670,"Hopewell city, Virginia",9193,7225,44,6242,939,1968
0500000US51027,"Buchanan County, Virginia",8871,6106,106,5202,798,2765
0500000US51069,"Frederick County, Virginia",30973,27634,101,24261,3272,3339
0500000US51179,"Stafford County, Virginia",46328,44611,124,42903,1584,1717
0500000US51199,"York County, Virginia",24617,23289,54,22020,1215,1328
0500000US51760,"Richmond city, Virginia",89846,77502,242,64913,12347,12344
0500000US51125,"Nelson County, Virginia",6445,5462,114,4102,1246,983
0500000US51143,"Pittsylvania County, Virginia",26330,20782,293,17158,3331,5548
0500000US51720,"Norton city, Virginia",1819,1522,6,1166,350,297
0500000US51065,"Fluvanna County, Virginia",9842,9195,54,8423,718,647
0500000US51007,"Amelia County, Virginia",4789,4111,8,3585,518,678
0500000US51840,"Winchester city, Virginia",10554,8693,24,7632,1037,1861
0500000US51001,"Accomack County, Virginia",13401,10611,74,8524,2013,2790
0500000US51063,"Floyd County, Virginia",6480,4994,14,4543,437,1486
0500000US51077,"Grayson County, Virginia",6542,4858,42,4157,659,1684
0500000US51135,"Nottoway County, Virginia",5542,4139,41,3512,586,1403
0500000US54033,"Harrison County, West Virginia",27436,22802,149,20518,2135,4634
0500000US54069,"Ohio County, West Virginia",17351,14246,89,11837,2320,3105
0500000US54013,"Calhoun County, West Virginia",2864,2187,91,1801,295,677
0500000US54065,"Morgan County, West Virginia",7166,6145,110,5312,723,1021
0500000US54081,"Raleigh County, West Virginia",31119,25351,108,22659,2584,5768
0500000US54007,"Braxton County, West Virginia",5491,4069,79,3482,508,1422
0500000US54001,"Barbour County, West Virginia",6416,5161,2,4332,827,1255
0500000US54047,"McDowell County, West Virginia",7711,5569,23,4646,900,2142
0500000US54099,"Wayne County, West Virginia",15799,11610,118,9588,1904,4189
0500000US54109,"Wyoming County, West Virginia",8823,6834,14,6039,781,1989
0500000US54035,"Jackson County, West Virginia",11178,8520,104,7305,1111,2658
0500000US54055,"Mercer County, West Virginia",24882,19549,76,16723,2750,5333
0500000US54097,"Upshur County, West Virginia",9378,7481,6,6467,1008,1897
0500000US54101,"Webster County, West Virginia",3811,2689,20,2455,214,1122
0500000US54003,"Berkeley County, West Virginia",43237,38668,247,34629,3792,4569
0500000US54019,"Fayette County, West Virginia",17795,14178,127,12534,1517,3617
0500000US54023,"Grant County, West Virginia",4556,3272,21,3056,195,1284
0500000US54027,"Hampshire County, West Virginia",9663,6785,56,5920,809,2878
0500000US54089,"Summers County, West Virginia",5489,3980,24,3202,754,1509
0500000US54009,"Brooke County, West Virginia",9957,8331,38,6979,1314,1626
0500000US54017,"Doddridge County, West Virginia",2647,2081,24,1683,374,566
0500000US54057,"Mineral County, West Virginia",11184,8362,43,7759,560,2822
0500000US54025,"Greenbrier County, West Virginia",15285,12080,125,10635,1320,3205
0500000US54031,"Hardy County, West Virginia",5521,4673,12,4159,502,848
0500000US54049,"Marion County, West Virginia",22942,19326,125,17644,1557,3616
0500000US54059,"Mingo County, West Virginia",10772,8137,24,7068,1045,2635
0500000US54029,"Hancock County, West Virginia",12697,10244,21,9077,1146,2453
0500000US54041,"Lewis County, West Virginia",6577,5235,37,4456,742,1342
0500000US54067,"Nicholas County, West Virginia",10472,8681,100,7629,952,1791
0500000US54075,"Pocahontas County, West Virginia",3579,2709,15,2505,189,870
0500000US54095,"Tyler County, West Virginia",3298,2531,49,2241,241,767
0500000US54083,"Randolph County, West Virginia",11254,8414,30,7330,1054,2840
0500000US54091,"Taylor County, West Virginia",6661,5411,30,4972,409,1250
0500000US54105,"Wirt County, West Virginia",2499,1953,0,1625,328,546
0500000US54015,"Clay County, West Virginia",3261,2348,0,2080,268,913
0500000US54021,"Gilmer County, West Virginia",2670,1985,30,1715,240,685
0500000US54061,"Monongalia County, West Virginia",38856,35109,132,32209,2768,3747
0500000US54063,"Monroe County, West Virginia",5744,4189,0,3610,579,1555
0500000US54103,"Wetzel County, West Virginia",5891,4393,55,3996,342,1498
0500000US54011,"Cabell County, West Virginia",39628,33237,258,27139,5840,6391
0500000US54039,"Kanawha County, West Virginia",79437,67372,249,59454,7669,12065
0500000US54071,"Pendleton County, West Virginia",3154,2156,31,1843,282,998
0500000US54077,"Preston County, West Virginia",12383,10250,83,9140,1027,2133
0500000US53035,"Kitsap County, Washington",101662,95844,338,90822,4684,5818
0500000US53033,"King County, Washington",865627,821382,2185,777496,41701,44245
0500000US53051,"Pend Oreille County, Washington",5782,5110,54,4012,1044,672
0500000US53055,"San Juan County, Washington",8025,7460,130,6666,664,565
0500000US53075,"Whitman County, Washington",17910,16957,75,14934,1948,953
0500000US53077,"Yakima County, Washington",82300,70582,560,61794,8228,11718
0500000US53015,"Cowlitz County, Washington",41397,36678,325,32694,3659,4719
0500000US53019,"Ferry County, Washington",3097,2496,101,1968,427,601
0500000US53041,"Lewis County, Washington",30262,26510,365,23114,3031,3752
0500000US53027,"Grays Harbor County, Washington",28263,24517,186,22728,1603,3746
0500000US53029,"Island County, Washington",34364,32258,151,30324,1783,2106
0500000US53069,"Wahkiakum County, Washington",1844,1612,26,1457,129,232
0500000US53021,"Franklin County, Washington",26316,23227,54,20685,2488,3089
0500000US53025,"Grant County, Washington",30651,26802,162,23956,2684,3849
0500000US53073,"Whatcom County, Washington",85008,78528,207,73211,5110,6480
0500000US53047,"Okanogan County, Washington",17527,14794,181,12856,1757,2733
0500000US53037,"Kittitas County, Washington",18003,16736,152,14944,1640,1267
0500000US53005,"Benton County, Washington",70983,64396,401,58155,5840,6587
0500000US53013,"Columbia County, Washington",1758,1520,0,1399,121,238
0500000US53003,"Asotin County, Washington",9171,8156,75,7169,912,1015
0500000US53023,"Garfield County, Washington",997,892,0,780,112,105
0500000US53045,"Mason County, Washington",23535,20897,283,19056,1558,2638
0500000US53065,"Stevens County, Washington",17433,14776,266,12543,1967,2657
0500000US53063,"Spokane County, Washington",198489,181332,1169,167373,12790,17157
0500000US53007,"Chelan County, Washington",28038,25271,132,21776,3363,2767
0500000US55105,"Rock County, Wisconsin",64538,56743,410,49287,7046,7795
0500000US55137,"Waushara County, Wisconsin",9869,8185,179,7115,891,1684
0500000US55001,"Adams County, Wisconsin",8619,7012,120,6095,797,1607
0500000US55007,"Bayfield County, Wisconsin",6963,5981,72,5438,471,982
0500000US55065,"Lafayette County, Wisconsin",6679,5433,118,4849,466,1246
0500000US55081,"Monroe County, Wisconsin",17772,14717,184,13306,1227,3055
0500000US55093,"Pierce County, Wisconsin",15367,13723,143,12417,1163,1644
0500000US55141,"Wood County, Wisconsin",32245,27260,267,25052,1941,4985
0500000US55003,"Ashland County, Wisconsin",6546,5389,68,4537,784,1157
0500000US55015,"Calumet County, Wisconsin",19567,17874,101,16786,987,1693
0500000US55037,"Florence County, Wisconsin",2010,1688,14,1379,295,322
0500000US55019,"Clark County, Wisconsin",12800,9743,175,8600,968,3057
0500000US55055,"Jefferson County, Wisconsin",32866,29095,296,26282,2517,3771
0500000US55059,"Kenosha County, Wisconsin",63423,57158,311,52202,4645,6265
0500000US55051,"Iron County, Wisconsin",3003,2529,56,2158,315,474
0500000US55109,"St. Croix County, Wisconsin",33674,31101,266,28266,2569,2573
0500000US55083,"Oconto County, Wisconsin",15940,13585,166,12177,1242,2355
0500000US55069,"Lincoln County, Wisconsin",12547,10745,113,9436,1196,1802
0500000US55135,"Waupaca County, Wisconsin",22024,18675,270,16762,1643,3349
0500000US55005,"Barron County, Wisconsin",19108,16360,152,14042,2166,2748
0500000US55113,"Sawyer County, Wisconsin",7634,6276,87,5536,653,1358
0500000US55047,"Green Lake County, Wisconsin",7935,6494,116,5704,674,1441
0500000US55077,"Marquette County, Wisconsin",6516,5341,82,4749,510,1175
0500000US55075,"Marinette County, Wisconsin",18631,15627,175,13783,1669,3004
0500000US55101,"Racine County, Wisconsin",76384,67271,399,61049,5823,9113
0500000US55139,"Winnebago County, Wisconsin",70173,62445,550,57092,4803,7728
0500000US55041,"Forest County, Wisconsin",4029,3256,45,2701,510,773
0500000US55043,"Grant County, Wisconsin",19401,16509,262,14601,1646,2892
0500000US55107,"Rusk County, Wisconsin",6382,5048,111,4300,637,1334
0500000US55117,"Sheboygan County, Wisconsin",47303,41557,303,38302,2952,5746
0500000US55067,"Langlade County, Wisconsin",8594,6946,92,6071,783,1648
0500000US55087,"Outagamie County, Wisconsin",72947,65968,539,61416,4013,6979
0500000US55123,"Vernon County, Wisconsin",12080,9570,185,8492,893,2510
0500000US55021,"Columbia County, Wisconsin",23790,20746,197,18626,1923,3044
0500000US55061,"Kewaunee County, Wisconsin",8238,6966,90,6112,764,1272
0500000US55009,"Brown County, Wisconsin",104133,93044,655,85600,6789,11089
0500000US55073,"Marathon County, Wisconsin",55377,48354,511,44202,3641,7023
0500000US55085,"Oneida County, Wisconsin",15403,13417,118,12116,1183,1986
0500000US55121,"Trempealeau County, Wisconsin",11936,9874,90,8992,792,2062
0500000US55129,"Washburn County, Wisconsin",7062,5981,101,5262,618,1081
0500000US55027,"Dodge County, Wisconsin",34605,29705,221,27264,2220,4900
0500000US55127,"Walworth County, Wisconsin",40372,36520,318,32473,3729,3852
0500000US55023,"Crawford County, Wisconsin",6618,5426,80,4777,569,1192
0500000US55071,"Manitowoc County, Wisconsin",34463,29492,355,26239,2898,4971
0500000US55111,"Sauk County, Wisconsin",26178,22485,224,20469,1792,3693
0500000US55013,"Burnett County, Wisconsin",7303,6199,112,5362,725,1104
0500000US55017,"Chippewa County, Wisconsin",25485,22452,240,20391,1821,3033
0500000US55029,"Door County, Wisconsin",13196,11733,91,10229,1413,1463
0500000US55031,"Douglas County, Wisconsin",18920,16634,201,14284,2149,2286
0500000US55053,"Jackson County, Wisconsin",8083,6646,103,5908,635,1437
0500000US55049,"Iowa County, Wisconsin",9835,8473,106,7647,720,1362
0500000US55089,"Ozaukee County, Wisconsin",35625,32753,129,30683,1941,2872
0500000US55103,"Richland County, Wisconsin",7626,6097,74,5295,728,1529
0500000US56005,"Campbell County, Wyoming",17488,16539,33,15567,939,949
0500000US56019,"Johnson County, Wyoming",3828,3232,49,2758,425,596
0500000US56025,"Natrona County, Wyoming",32851,29672,130,26227,3315,3179
0500000US56009,"Converse County, Wyoming",5429,4975,59,4216,700,454
0500000US56027,"Niobrara County, Wyoming",978,872,0,714,158,106
0500000US56039,"Teton County, Wyoming",9158,8770,42,7849,879,388
0500000US56037,"Sweetwater County, Wyoming",15871,14644,252,12979,1413,1227
0500000US56031,"Platte County, Wyoming",3936,3318,57,2722,539,618
0500000US56029,"Park County, Wyoming",11977,11027,136,9813,1078,950
0500000US56033,"Sheridan County, Wyoming",13159,11391,41,10549,801,1768
0500000US56003,"Big Horn County, Wyoming",4494,3965,15,3310,640,529
0500000US56011,"Crook County, Wyoming",2924,2623,19,2105,499,301
0500000US56001,"Albany County, Wyoming",16027,15039,30,13151,1858,988
0500000US56007,"Carbon County, Wyoming",6341,5345,65,4712,568,996
0500000US56015,"Goshen County, Wyoming",5209,4371,39,3797,535,838
0500000US56041,"Uinta County, Wyoming",7735,7263,27,6769,467,472
0500000US56043,"Washakie County, Wyoming",3422,3007,7,2650,350,415
0500000US56017,"Hot Springs County, Wyoming",2209,1915,32,1658,225,294
0500000US56013,"Fremont County, Wyoming",15003,13088,91,11073,1924,1915
0500000US56035,"Sublette County, Wyoming",3275,3098,25,2672,401,177
0500000US56045,"Weston County, Wyoming",3062,2640,17,2245,378,422
0500000US72065,"Hatillo Municipio, Puerto Rico",14093,8392,57,7299,1036,5701
0500000US72069,"Humacao Municipio, Puerto Rico",17896,11921,35,10091,1795,5975
0500000US72101,"Morovis Municipio, Puerto Rico",9943,6830,54,5678,1098,3113
0500000US72097,"Mayagüez Municipio, Puerto Rico",29912,20104,175,17345,2584,9808
0500000US72139,"Trujillo Alto Municipio, Puerto Rico",23982,18750,44,16373,2333,5232
0500000US72115,"Quebradillas Municipio, Puerto Rico",8286,5341,19,3999,1323,2945
0500000US72099,"Moca Municipio, Puerto Rico",13278,8729,29,7548,1152,4549
0500000US72049,"Culebra Municipio, Puerto Rico",475,341,0,293,48,134
0500000US72123,"Salinas Municipio, Puerto Rico",10374,5201,39,4133,1029,5173
0500000US72017,"Barceloneta Municipio, Puerto Rico",8010,5164,88,3703,1373,2846
0500000US72153,"Yauco Municipio, Puerto Rico",10790,5918,270,4726,922,4872
0500000US72061,"Guaynabo Municipio, Puerto Rico",30963,24361,202,21467,2692,6602
0500000US72023,"Cabo Rojo Municipio, Puerto Rico",15656,3539,61,3081,397,12117
0500000US72053,"Fajardo Municipio, Puerto Rico",12231,8804,51,7871,882,3427
0500000US72109,"Patillas Municipio, Puerto Rico",6233,3504,10,2970,524,2729
0500000US72117,"Rincón Municipio, Puerto Rico",5128,3292,298,2624,370,1836
0500000US72007,"Aguas Buenas Municipio, Puerto Rico",8469,4972,111,4231,630,3497
0500000US72021,"Bayamón Municipio, Puerto Rico",67940,52596,274,45883,6439,15344
0500000US72035,"Cayey Municipio, Puerto Rico",16183,10402,188,9170,1044,5781
0500000US72095,"Maunabo Municipio, Puerto Rico",3882,2311,0,1746,565,1571
0500000US72111,"Peñuelas Municipio, Puerto Rico",6987,4445,0,4137,308,2542
0500000US72131,"San Sebastián Municipio, Puerto Rico",13904,6952,217,4791,1944,6952
0500000US72135,"Toa Alta Municipio, Puerto Rico",22032,16751,83,11368,5300,5281
0500000US72147,"Vieques Municipio, Puerto Rico",2470,1380,11,1228,141,1090
0500000US72151,"Yabucoa Municipio, Puerto Rico",11722,6713,38,5466,1209,5009
0500000US72025,"Caguas Municipio, Puerto Rico",48629,35178,333,30927,3918,13451
0500000US72029,"Canóvanas Municipio, Puerto Rico",14498,10743,40,10104,599,3755
0500000US72043,"Coamo Municipio, Puerto Rico",13346,6177,57,5251,869,7169
0500000US72051,"Dorado Municipio, Puerto Rico",11881,9605,48,5765,3792,2276
0500000US72019,"Barranquitas Municipio, Puerto Rico",8918,4308,23,3117,1168,4610
0500000US72107,"Orocovis Municipio, Puerto Rico",6734,3615,10,2925,680,3119
0500000US72011,"Añasco Municipio, Puerto Rico",8933,5752,728,4154,870,3181
0500000US72037,"Ceiba Municipio, Puerto Rico",4367,2907,8,2445,454,1460
0500000US72045,"Comerío Municipio, Puerto Rico",5836,2756,24,1812,920,3080
0500000US72071,"Isabela Municipio, Puerto Rico",15012,8834,21,6245,2568,6178
0500000US72081,"Lares Municipio, Puerto Rico",9960,5035,80,4017,938,4925
0500000US72085,"Las Piedras Municipio, Puerto Rico",12527,8093,270,6924,899,4434
0500000US72127,"San Juan Municipio, Puerto Rico",144573,89604,2198,71229,16177,54969
0500000US72143,"Vega Alta Municipio, Puerto Rico",12229,7542,28,5441,2073,4687
0500000US72093,"Maricao Municipio, Puerto Rico",1930,723,0,558,165,1207
0500000US72009,"Aibonito Municipio, Puerto Rico",8301,4093,11,3738,344,4208
0500000US72077,"Juncos Municipio, Puerto Rico",12718,9348,32,8851,465,3370
0500000US72121,"Sabana Grande Municipio, Puerto Rico",7493,3907,258,3125,524,3586
0500000US72067,"Hormigueros Municipio, Puerto Rico",6253,4108,7,3564,537,2145
0500000US72001,"Adjuntas Municipio, Puerto Rico",5861,3007,64,2321,622,2854
0500000US72027,"Camuy Municipio, Puerto Rico",11431,6695,90,5293,1312,4736
0500000US72055,"Guánica Municipio, Puerto Rico",5469,2761,177,2166,418,2708
0500000US72091,"Manatí Municipio, Puerto Rico",15337,10033,22,6595,3416,5304
0500000US72103,"Naguabo Municipio, Puerto Rico",8317,6130,0,5375,755,2187
0500000US72105,"Naranjito Municipio, Puerto Rico",8520,4956,36,3553,1367,3564
0500000US72125,"San Germán Municipio, Puerto Rico",11840,5259,60,4225,974,6581
0500000US72141,"Utuado Municipio, Puerto Rico",9851,5627,49,4613,965,4224
0500000US72013,"Arecibo Municipio, Puerto Rico",31788,19937,202,16530,3205,11851
0500000US72015,"Arroyo Municipio, Puerto Rico",6002,2949,0,2677,272,3053
0500000US72033,"Cataño Municipio, Puerto Rico",8792,6007,15,4680,1312,2785
0500000US72054,"Florida Municipio, Puerto Rico",4291,2820,27,1766,1027,1471
0500000US01099,"Monroe County, Alabama",8149,4107,62,3334,711,4042
0500000US01079,"Lawrence County, Alabama",12811,9740,117,7521,2102,3071
0500000US01081,"Lee County, Alabama",59373,53634,201,47379,6054,5739
0500000US01107,"Pickens County, Alabama",7530,5487,43,4649,795,2043
0500000US01119,"Sumter County, Alabama",5047,3571,20,2868,683,1476
0500000US01023,"Choctaw County, Alabama",5350,3962,43,3110,809,1388
0500000US01091,"Marengo County, Alabama",7768,5239,81,4051,1107,2529
0500000US01113,"Russell County, Alabama",22740,18755,76,14906,3773,3985
0500000US01039,"Covington County, Alabama",15008,11491,118,10217,1156,3517
0500000US01041,"Crenshaw County, Alabama",5025,3562,12,2974,576,1463
0500000US01077,"Lauderdale County, Alabama",38514,31102,179,26084,4839,7412
0500000US01085,"Lowndes County, Alabama",4180,2769,26,1984,759,1411
0500000US01083,"Limestone County, Alabama",32126,27556,187,24464,2905,4570
0500000US01115,"St. Clair County, Alabama",32172,27482,313,23938,3231,4690
0500000US01133,"Winston County, Alabama",9403,7120,81,5734,1305,2283
0500000US01043,"Cullman County, Alabama",30730,24987,238,21279,3470,5743
0500000US01051,"Elmore County, Alabama",29143,25249,69,22748,2432,3894
0500000US01071,"Jackson County, Alabama",20626,16151,100,13661,2390,4475
0500000US01121,"Talladega County, Alabama",31407,25433,135,21653,3645,5974
0500000US01129,"Washington County, Alabama",6007,4566,62,3497,1007,1441
0500000US01031,"Coffee County, Alabama",19789,16922,173,15093,1656,2867
0500000US01103,"Morgan County, Alabama",45646,38314,308,32943,5063,7332
0500000US01021,"Chilton County, Alabama",16751,13072,78,10236,2758,3679
0500000US01033,"Colbert County, Alabama",21799,17745,148,14768,2829,4054
0500000US01045,"Dale County, Alabama",18670,15756,148,13329,2279,2914
0500000US01055,"Etowah County, Alabama",38777,32325,154,28109,4062,6452
0500000US01049,"DeKalb County, Alabama",26132,20639,157,17348,3134,5493
0500000US01075,"Lamar County, Alabama",5974,4583,55,3725,803,1391
0500000US01111,"Randolph County, Alabama",8643,6878,174,5891,813,1765
0500000US01097,"Mobile County, Alabama",155831,128605,1049,111079,16477,27226
0500000US01127,"Walker County, Alabama",25036,20022,150,16803,3069,5014
0500000US01029,"Cleburne County, Alabama",5726,4574,56,3444,1074,1152
0500000US01063,"Greene County, Alabama",2955,1631,2,1327,302,1324
0500000US01005,"Barbour County, Alabama",9186,6986,68,5490,1428,2200
0500000US01011,"Bullock County, Alabama",3609,2631,24,2097,510,978
0500000US01015,"Calhoun County, Alabama",45033,38124,198,32484,5442,6909
0500000US01025,"Clarke County, Alabama",9358,6109,56,4860,1193,3249
0500000US01101,"Montgomery County, Alabama",89835,77208,217,68644,8347,12627
0500000US01095,"Marshall County, Alabama",34896,28801,41,25781,2979,6095
0500000US01067,"Henry County, Alabama",6669,5402,80,4712,610,1267
0500000US01089,"Madison County, Alabama",145256,131997,367,121167,10463,13259
0500000US01123,"Tallapoosa County, Alabama",16448,13130,30,11411,1689,3318
0500000US02016,"Aleutians West Census Area, Alaska",1176,1090,4,885,201,86
0500000US01131,"Wilcox County, Alabama",3804,2373,59,1860,454,1431
0500000US02068,"Denali Borough, Alaska",639,606,0,561,45,33
0500000US02122,"Kenai Peninsula Borough, Alaska",21741,19583,293,16613,2677,2158
0500000US02060,"Bristol Bay Borough, Alaska",333,308,6,271,31,25
0500000US02150,"Kodiak Island Borough, Alaska",4373,3904,0,3586,318,469
0500000US02188,"Northwest Arctic Borough, Alaska",1860,1529,0,1293,236,331
0500000US02050,"Bethel Census Area, Alaska",4558,3914,0,3270,644,644
0500000US02185,"North Slope Borough, Alaska",1966,1661,8,1324,329,305
0500000US02220,"Sitka City and Borough, Alaska",3561,3293,14,2948,331,268
0500000US02090,"Fairbanks North Star Borough, Alaska",36513,34686,269,30810,3607,1827
0500000US02130,"Ketchikan Gateway Borough, Alaska",5327,4884,13,4416,455,443
0500000US02170,"Matanuska-Susitna Borough, Alaska",30879,29098,173,26556,2369,1781
0500000US02180,"Nome Census Area, Alaska",2875,2550,0,2059,491,325
0500000US02070,"Dillingham Census Area, Alaska",1420,1231,2,1077,152,189
0500000US02100,"Haines Borough, Alaska",1026,983,17,897,69,43
0500000US02282,"Yakutat City and Borough, Alaska",232,210,3,161,46,22
0500000US02110,"Juneau City and Borough, Alaska",12521,11896,35,11060,801,625
0500000US02164,"Lake and Peninsula Borough, Alaska",425,352,1,259,92,73
0500000US02240,"Southeast Fairbanks Census Area, Alaska",2163,1938,11,1551,376,225
0500000US02290,"Yukon-Koyukuk Census Area, Alaska",1906,1267,4,827,436,639
0500000US02020,"Anchorage Municipality, Alaska",106524,101673,299,93953,7421,4851
0500000US02013,"Aleutians East Borough, Alaska",860,744,0,575,169,116
0500000US02230,"Skagway Municipality, Alaska",400,385,0,342,43,15
0500000US02198,"Prince of Wales-Hyder Census Area, Alaska",2356,2015,3,1571,441,341
0500000US02195,"Petersburg Borough, Alaska",1170,1061,2,914,145,109
0500000US02158,"Kusilvak Census Area, Alaska",1692,1353,0,1050,303,339
0500000US04013,"Maricopa County, Arizona",1520767,1391290,5409,1270545,115336,129477
0500000US04009,"Graham County, Arizona",10782,9363,17,7713,1633,1419
0500000US04023,"Santa Cruz County, Arizona",15430,12538,77,10543,1918,2892
0500000US04012,"La Paz County, Arizona",8912,6815,31,5388,1396,2097
0500000US04015,"Mohave County, Arizona",85485,73527,553,66344,6630,11958
0500000US04005,"Coconino County, Arizona",47276,42098,195,36335,5568,5178
0500000US04027,"Yuma County, Arizona",72463,60556,296,54767,5493,11907
0500000US04011,"Greenlee County, Arizona",3225,2882,9,2452,421,343
0500000US04021,"Pinal County, Arizona",137286,121980,478,109436,12066,15306
0500000US05123,"St. Francis County, Arkansas",9319,6974,32,4765,2177,2345
0500000US05145,"White County, Arkansas",29263,24768,101,21352,3315,4495
0500000US05099,"Nevada County, Arkansas",3303,2315,89,1745,481,988
0500000US05037,"Cross County, Arkansas",6694,5141,16,4370,755,1553
0500000US05043,"Drew County, Arkansas",7018,5671,59,4665,947,1347
0500000US05027,"Columbia County, Arkansas",8962,6356,27,5274,1055,2606
0500000US05125,"Saline County, Arkansas",43604,39175,160,35037,3978,4429
0500000US05141,"Van Buren County, Arkansas",6852,5362,100,4096,1166,1490
0500000US05065,"Izard County, Arkansas",5049,4285,50,2841,1394,764
0500000US05079,"Lincoln County, Arkansas",3795,2904,21,2189,694,891
0500000US05083,"Logan County, Arkansas",8464,7066,57,5770,1239,1398
0500000US05035,"Crittenden County, Arkansas",18756,14963,78,13294,1591,3793
0500000US05047,"Franklin County, Arkansas",6800,5313,147,4087,1079,1487
0500000US05109,"Pike County, Arkansas",4299,3220,7,2617,596,1079
0500000US05069,"Jefferson County, Arkansas",26977,21841,179,15069,6593,5136
0500000US05097,"Montgomery County, Arkansas",3761,2818,29,2182,607,943
0500000US05127,"Scott County, Arkansas",3855,2835,26,2092,717,1020
0500000US05131,"Sebastian County, Arkansas",50670,42727,94,36603,6030,7943
0500000US05007,"Benton County, Arkansas",94333,86384,297,60889,25198,7949
0500000US05017,"Chicot County, Arkansas",4308,3127,10,2581,536,1181
0500000US05071,"Johnson County, Arkansas",9800,7737,54,6251,1432,2063
0500000US05077,"Lee County, Arkansas",3352,2308,68,1692,548,1044
0500000US05115,"Pope County, Arkansas",22628,19599,207,16052,3340,3029
0500000US05041,"Desha County, Arkansas",5111,3834,53,2489,1292,1277
0500000US05049,"Fulton County, Arkansas",5000,4140,0,2913,1227,860
0500000US05051,"Garland County, Arkansas",39894,34533,205,30128,4200,5361
0500000US05117,"Prairie County, Arkansas",3826,2931,18,2065,848,895
0500000US39161,"Van Wert County, Ohio",11419,9886,160,8314,1412,1533
0500000US39167,"Washington County, Ohio",25139,20279,217,17489,2573,4860
0500000US39171,"Williams County, Ohio",15246,13001,112,11782,1107,2245
0500000US39011,"Auglaize County, Ohio",18723,16622,119,15358,1145,2101
0500000US39029,"Columbiana County, Ohio",41854,35284,204,31194,3886,6570
0500000US39037,"Darke County, Ohio",20838,17711,289,15511,1911,3127
0500000US39123,"Ottawa County, Ohio",17691,15924,145,14158,1621,1767
0500000US39051,"Fulton County, Ohio",16425,14592,141,13160,1291,1833
0500000US39065,"Hardin County, Ohio",11495,9469,73,8277,1119,2026
0500000US39079,"Jackson County, Ohio",12892,10652,110,9346,1196,2240
0500000US39095,"Lucas County, Ohio",179065,157874,589,139100,18185,21191
0500000US39117,"Morrow County, Ohio",12650,10711,109,9337,1265,1939
0500000US39121,"Noble County, Ohio",4967,3609,36,3173,400,1358
0500000US39135,"Preble County, Ohio",16090,13889,155,12360,1374,2201
0500000US39147,"Seneca County, Ohio",21652,18564,139,16345,2080,3088
0500000US39151,"Stark County, Ohio",152649,133208,540,123105,9563,19441
0500000US39003,"Allen County, Ohio",40537,34970,181,31138,3651,5567
0500000US39031,"Coshocton County, Ohio",14461,11279,137,9655,1487,3182
0500000US39033,"Crawford County, Ohio",17755,14820,155,13223,1442,2935
0500000US39041,"Delaware County, Ohio",68649,65793,245,63036,2512,2856
0500000US39059,"Guernsey County, Ohio",16098,13056,178,11378,1500,3042
0500000US39073,"Hocking County, Ohio",11120,9300,153,7848,1299,1820
0500000US39107,"Mercer County, Ohio",16104,14192,136,13021,1035,1912
0500000US39141,"Ross County, Ohio",28747,24454,105,21276,3073,4293
0500000US39035,"Cuyahoga County, Ohio",538531,460818,2152,410830,47836,77713
0500000US39093,"Lorain County, Ohio",119536,105862,686,93412,11764,13674
0500000US39109,"Miami County, Ohio",41081,36001,235,33177,2589,5080
0500000US39113,"Montgomery County, Ohio",223894,196305,912,179001,16392,27589
0500000US39155,"Trumbull County, Ohio",86163,71214,386,62884,7944,14949
0500000US39173,"Wood County, Ohio",50443,46239,519,41705,4015,4204
0500000US39007,"Ashtabula County, Ohio",37652,30558,288,27496,2774,7094
0500000US40001,"Adair County, Oklahoma",7742,5478,31,3749,1698,2264
0500000US40137,"Stephens County, Oklahoma",16955,14253,90,12139,2024,2702
0500000US40025,"Cimarron County, Oklahoma",974,786,0,621,165,188
0500000US40019,"Carter County, Oklahoma",18336,15353,64,11426,3863,2983
0500000US40053,"Grant County, Oklahoma",1825,1544,7,1298,239,281
0500000US40055,"Greer County, Oklahoma",2041,1621,11,1409,201,420
0500000US40087,"McClain County, Oklahoma",14159,12689,56,11685,948,1470
0500000US40091,"McIntosh County, Oklahoma",8413,6666,86,5000,1580,1747
0500000US40099,"Murray County, Oklahoma",5354,4549,20,3364,1165,805
0500000US40103,"Noble County, Oklahoma",4607,3780,10,3125,645,827
0500000US40115,"Ottawa County, Oklahoma",11965,9258,35,7450,1773,2707
0500000US40135,"Sequoyah County, Oklahoma",15376,12547,115,10120,2312,2829
0500000US40145,"Wagoner County, Oklahoma",28748,26479,110,24263,2106,2269
0500000US40151,"Woods County, Oklahoma",3351,2894,14,2517,363,457
0500000US40015,"Caddo County, Oklahoma",10199,8085,19,6275,1791,2114
0500000US40101,"Muskogee County, Oklahoma",26078,21163,102,16874,4187,4915
0500000US40107,"Okfuskee County, Oklahoma",3962,2985,15,2440,530,977
0500000US40013,"Bryan County, Oklahoma",17157,14545,92,11774,2679,2612
0500000US40059,"Harper County, Oklahoma",1297,1090,5,893,192,207
0500000US40071,"Kay County, Oklahoma",17703,14815,94,11611,3110,2888
0500000US40035,"Craig County, Oklahoma",5433,4273,25,3510,738,1160
0500000US40143,"Tulsa County, Oklahoma",251176,225658,653,203855,21150,25518
0500000US40017,"Canadian County, Oklahoma",44633,41245,61,37752,3432,3388
0500000US40057,"Harmon County, Oklahoma",1183,988,10,832,146,195
0500000US40127,"Pushmataha County, Oklahoma",4463,3333,18,2792,523,1130
0500000US40077,"Latimer County, Oklahoma",4042,3165,26,2569,570,877
0500000US40113,"Osage County, Oklahoma",18165,15150,74,12428,2648,3015
0500000US40139,"Texas County, Oklahoma",6725,5618,13,4639,966,1107
0500000US40047,"Garfield County, Oklahoma",23824,20443,90,17981,2372,3381
0500000US40069,"Johnston County, Oklahoma",4300,3276,34,2567,675,1024
0500000US40121,"Pittsburg County, Oklahoma",17745,14605,45,12466,2094,3140
0500000US40129,"Roger Mills County, Oklahoma",1352,1114,17,874,223,238
0500000US40153,"Woodward County, Oklahoma",7255,6402,23,5449,930,853
0500000US40021,"Cherokee County, Oklahoma",16507,12877,54,10288,2535,3630
0500000US40041,"Delaware County, Oklahoma",16574,13798,85,11208,2505,2776
0500000US40045,"Ellis County, Oklahoma",1607,1342,10,1079,253,265
0500000US40051,"Grady County, Oklahoma",19836,17057,86,13300,3671,2779
0500000US40119,"Payne County, Oklahoma",30485,27358,133,24111,3114,3127
0500000US40125,"Pottawatomie County, Oklahoma",26003,22084,130,18201,3753,3919
0500000US40037,"Creek County, Oklahoma",26642,22203,96,19785,2322,4439
0500000US40141,"Tillman County, Oklahoma",2954,2385,23,2017,345,569
0500000US40149,"Washita County, Oklahoma",4363,3802,16,2981,805,561
0500000US40033,"Cotton County, Oklahoma",2212,1812,29,1490,293,400
0500000US40075,"Kiowa County, Oklahoma",3772,2993,10,2603,380,779
0500000US40079,"Le Flore County, Oklahoma",18367,14054,104,11864,2086,4313
0500000US40089,"McCurtain County, Oklahoma",12791,8677,51,7072,1554,4114
0500000US40093,"Major County, Oklahoma",3050,2593,27,2191,375,457
0500000US40097,"Mayes County, Oklahoma",15838,13475,113,11624,1738,2363
0500000US40109,"Oklahoma County, Oklahoma",299232,265834,713,236069,29052,33398
0500000US40039,"Custer County, Oklahoma",10505,9502,49,8195,1258,1003
0500000US40007,"Beaver County, Oklahoma",2027,1693,2,1499,192,334
0500000US40085,"Love County, Oklahoma",3193,2655,0,2065,590,538
0500000US40009,"Beckham County, Oklahoma",7562,6575,26,5669,880,987
0500000US40023,"Choctaw County, Oklahoma",5991,4234,40,3454,740,1757
0500000US40065,"Jackson County, Oklahoma",9868,8408,59,7567,782,1460
0500000US40081,"Lincoln County, Oklahoma",12821,10349,167,7940,2242,2472
0500000US41047,"Marion County, Oregon",116861,106405,646,96741,9018,10456
0500000US41029,"Jackson County, Oregon",87417,79417,552,72148,6717,8000
0500000US41023,"Grant County, Oregon",3294,2765,19,2504,242,529
0500000US41031,"Jefferson County, Oregon",7892,6907,18,6101,788,985
0500000US41005,"Clackamas County, Oregon",155456,145407,805,135163,9439,10049
0500000US41043,"Linn County, Oregon",47030,42025,277,37662,4086,5005
0500000US41057,"Tillamook County, Oregon",10816,9329,83,8352,894,1487
0500000US41001,"Baker County, Oregon",6927,5938,51,4967,920,989
0500000US41033,"Josephine County, Oregon",35978,31594,331,28053,3210,4384
0500000US41059,"Umatilla County, Oregon",26886,23428,92,20644,2692,3458
0500000US41041,"Lincoln County, Oregon",21110,18669,153,16685,1831,2441
0500000US41009,"Columbia County, Oregon",19296,17156,166,15816,1174,2140
0500000US41055,"Sherman County, Oregon",736,643,6,544,93,93
0500000US41065,"Wasco County, Oregon",10266,8820,122,7620,1078,1446
0500000US41039,"Lane County, Oregon",150780,139001,962,124293,13746,11779
0500000US41045,"Malheur County, Oregon",10138,8382,58,7031,1293,1756
0500000US41067,"Washington County, Oregon",216507,206734,637,192241,13856,9773
0500000US41049,"Morrow County, Oregon",3959,3487,35,2966,486,472
0500000US41007,"Clatsop County, Oregon",15910,14096,37,12849,1210,1814
0500000US41015,"Curry County, Oregon",10440,8870,131,7676,1063,1570
0500000US41021,"Gilliam County, Oregon",848,694,16,589,89,154
0500000US41037,"Lake County, Oregon",3494,2792,3,2140,649,702
0500000US41061,"Union County, Oregon",10481,9188,100,8211,877,1293
0500000US42045,"Delaware County, Pennsylvania",206405,185781,631,171980,13170,20624
0500000US42119,"Union County, Pennsylvania",14739,12171,125,10736,1310,2568
0500000US42127,"Wayne County, Pennsylvania",18739,16012,431,14292,1289,2727
0500000US42043,"Dauphin County, Pennsylvania",111684,96990,611,87895,8484,14694
0500000US42129,"Westmoreland County, Pennsylvania",151665,128622,1043,116906,10673,23043
0500000US42053,"Forest County, Pennsylvania",1631,1255,34,1010,211,376
0500000US42089,"Monroe County, Pennsylvania",56770,51274,343,46550,4381,5496
0500000US42101,"Philadelphia County, Pennsylvania",594778,499964,2245,432292,65427,94814
0500000US42013,"Blair County, Pennsylvania",51625,42505,247,38248,4010,9120
0500000US42021,"Cambria County, Pennsylvania",56793,45708,367,41488,3853,11085
0500000US42011,"Berks County, Pennsylvania",154467,134423,1305,123482,9636,20044
0500000US42061,"Huntingdon County, Pennsylvania",16808,13863,168,12242,1453,2945
0500000US42073,"Lawrence County, Pennsylvania",36907,30566,381,27200,2985,6341
0500000US42087,"Mifflin County, Pennsylvania",19094,14790,240,12547,2003,4304
0500000US42041,"Cumberland County, Pennsylvania",98877,88125,519,81304,6302,10752
0500000US42003,"Allegheny County, Pennsylvania",537960,471383,2165,434359,34859,66577
0500000US42109,"Snyder County, Pennsylvania",14716,11979,128,10718,1133,2737
0500000US42115,"Susquehanna County, Pennsylvania",17347,14988,195,13511,1282,2359
0500000US42039,"Crawford County, Pennsylvania",35012,29044,379,25863,2802,5968
0500000US42049,"Erie County, Pennsylvania",110050,95522,954,85942,8626,14528
0500000US42057,"Fulton County, Pennsylvania",5950,4676,98,4004,574,1274
0500000US42067,"Juniata County, Pennsylvania",9404,7430,150,6646,634,1974
0500000US42107,"Schuylkill County, Pennsylvania",58733,47947,428,43058,4461,10786
0500000US42131,"Wyoming County, Pennsylvania",10784,9367,119,8760,488,1417
0500000US42001,"Adams County, Pennsylvania",39221,34012,465,30417,3130,5209
0500000US42005,"Armstrong County, Pennsylvania",27990,22823,364,20282,2177,5167
0500000US42035,"Clinton County, Pennsylvania",14744,12270,183,10883,1204,2474
0500000US42025,"Carbon County, Pennsylvania",25739,21961,221,19783,1957,3778
0500000US42027,"Centre County, Pennsylvania",57908,52758,407,46996,5355,5150
0500000US42097,"Northumberland County, Pennsylvania",39132,30709,373,27391,2945,8423
0500000US42095,"Northampton County, Pennsylvania",114123,100330,730,91525,8075,13793
0500000US42023,"Cameron County, Pennsylvania",2232,1786,12,1580,194,446
0500000US42121,"Venango County, Pennsylvania",21915,18362,206,16236,1920,3553
0500000US42007,"Beaver County, Pennsylvania",70817,59836,423,54867,4546,10981
0500000US42017,"Bucks County, Pennsylvania",237383,217835,745,206225,10865,19548
0500000US42069,"Lackawanna County, Pennsylvania",86628,72411,703,65362,6346,14217
0500000US42083,"McKean County, Pennsylvania",17169,14398,134,12495,1769,2771
0500000US42051,"Fayette County, Pennsylvania",54511,43215,310,38893,4012,11296
0500000US42091,"Montgomery County, Pennsylvania",313949,289853,1067,274945,13841,24096
0500000US42059,"Greene County, Pennsylvania",14211,11858,99,10735,1024,2353
0500000US42075,"Lebanon County, Pennsylvania",53281,45314,296,41349,3669,7967
0500000US42079,"Luzerne County, Pennsylvania",128054,105852,1174,94774,9904,22202
0500000US42093,"Montour County, Pennsylvania",7482,6267,64,5616,587,1215
0500000US42037,"Columbia County, Pennsylvania",26582,22198,201,19916,2081,4384
0500000US42019,"Butler County, Pennsylvania",76240,67340,503,62820,4017,8900
0500000US42065,"Jefferson County, Pennsylvania",18465,14543,177,13036,1330,3922
0500000US42071,"Lancaster County, Pennsylvania",199889,171173,1618,151904,17651,28716
0500000US42099,"Perry County, Pennsylvania",18091,15208,268,13542,1398,2883
0500000US42105,"Potter County, Pennsylvania",6523,5355,76,4839,440,1168
0500000US42117,"Tioga County, Pennsylvania",16178,13495,309,12047,1139,2683
0500000US44007,"Providence County, Rhode Island",238171,204378,932,186862,16584,33793
0500000US44001,"Bristol County, Rhode Island",19553,17375,144,16279,952,2178
0500000US44005,"Newport County, Rhode Island",35217,31836,172,29284,2380,3381
0500000US45003,"Aiken County, South Carolina",66710,57876,517,49849,7510,8834
0500000US45071,"Newberry County, South Carolina",14939,11382,135,9335,1912,3557
0500000US45037,"Edgefield County, South Carolina",9063,6956,79,5661,1216,2107
0500000US45027,"Clarendon County, South Carolina",13327,10223,61,8449,1713,3104
0500000US45029,"Colleton County, South Carolina",15145,13000,118,11425,1457,2145
0500000US45085,"Sumter County, South Carolina",41137,34046,228,29382,4436,7091
0500000US45063,"Lexington County, South Carolina",111265,99701,410,89014,10277,11564
0500000US45011,"Barnwell County, South Carolina",8326,6245,34,4978,1233,2081
0500000US45091,"York County, South Carolina",98155,89843,257,82183,7403,8312
0500000US45015,"Berkeley County, South Carolina",74931,68266,297,59961,8008,6665
0500000US45031,"Darlington County, South Carolina",26592,20026,113,17136,2777,6566
0500000US45043,"Georgetown County, South Carolina",25111,21278,62,18192,3024,3833
0500000US45007,"Anderson County, South Carolina",76632,65087,174,55313,9600,11545
0500000US45025,"Chesterfield County, South Carolina",17977,13507,43,10755,2709,4470
0500000US45047,"Greenwood County, South Carolina",27207,22100,164,18812,3124,5107
0500000US45051,"Horry County, South Carolina",128586,116036,577,103794,11665,12550
0500000US45055,"Kershaw County, South Carolina",24833,20330,129,16859,3342,4503
0500000US45075,"Orangeburg County, South Carolina",32966,25096,235,20583,4278,7870
0500000US45001,"Abbeville County, South Carolina",9455,7289,21,6112,1156,2166
0500000US45009,"Bamberg County, South Carolina",5422,4099,54,3025,1020,1323
0500000US45017,"Calhoun County, South Carolina",6121,4668,77,4011,580,1453
0500000US45033,"Dillon County, South Carolina",10968,7932,38,5587,2307,3036
0500000US45079,"Richland County, South Carolina",150309,137487,350,119289,17848,12822
0500000US45039,"Fairfield County, South Carolina",8979,6640,41,4636,1963,2339
0500000US45049,"Hampton County, South Carolina",6924,5291,42,4519,730,1633
0500000US45045,"Greenville County, South Carolina",189334,165656,438,150057,15161,23678
0500000US45057,"Lancaster County, South Carolina",32632,27834,145,24628,3061,4798
0500000US45035,"Dorchester County, South Carolina",54549,49329,153,43209,5967,5220
0500000US45041,"Florence County, South Carolina",52051,42829,183,36593,6053,9222
0500000US45059,"Laurens County, South Carolina",25373,20501,199,16916,3386,4872
0500000US45065,"McCormick County, South Carolina",3967,3066,11,2628,427,901
0500000US45077,"Pickens County, South Carolina",47375,40511,201,35380,4930,6864
0500000US45087,"Union County, South Carolina",11544,8722,39,7101,1582,2822
0500000US45089,"Williamsburg County, South Carolina",12411,8440,30,5890,2520,3971
0500000US46003,"Aurora County, South Dakota",1161,919,8,810,101,242
0500000US46051,"Grant County, South Dakota",3212,2726,31,2504,191,486
0500000US46123,"Tripp County, South Dakota",2406,2025,3,1727,295,381
0500000US46071,"Jackson County, South Dakota",884,568,3,447,118,316
0500000US46099,"Minnehaha County, South Dakota",75049,67765,446,60917,6402,7284
0500000US46033,"Custer County, South Dakota",3941,3458,74,2960,424,483
0500000US46069,"Hyde County, South Dakota",598,502,0,461,41,96
0500000US46025,"Clark County, South Dakota",1536,1241,18,1052,171,295
0500000US46049,"Faulk County, South Dakota",902,692,6,616,70,210
0500000US46077,"Kingsbury County, South Dakota",2296,1897,11,1650,236,399
0500000US46129,"Walworth County, South Dakota",2296,1770,19,1486,265,526
0500000US46027,"Clay County, South Dakota",5223,4911,4,4568,339,312
0500000US46037,"Day County, South Dakota",2599,2137,22,1688,427,462
0500000US46043,"Douglas County, South Dakota",1250,992,7,841,144,258
0500000US46063,"Harding County, South Dakota",548,492,2,453,37,56
0500000US46089,"McPherson County, South Dakota",1012,744,0,650,94,268
0500000US46109,"Roberts County, South Dakota",3824,3058,19,2662,377,766
0500000US46119,"Sully County, South Dakota",567,479,3,437,39,88
0500000US46083,"Lincoln County, South Dakota",19294,18242,135,17068,1039,1052
0500000US46079,"Lake County, South Dakota",4675,4102,17,3738,347,573
0500000US46081,"Lawrence County, South Dakota",11022,9801,23,8961,817,1221
0500000US46029,"Codington County, South Dakota",11974,10528,53,9179,1296,1446
0500000US46019,"Butte County, South Dakota",4178,3485,12,3088,385,693
0500000US46031,"Corson County, South Dakota",1186,732,0,639,93,454
0500000US46045,"Edmunds County, South Dakota",1563,1326,4,1109,213,237
0500000US46021,"Campbell County, South Dakota",658,512,2,444,66,146
0500000US46007,"Bennett County, South Dakota",985,764,9,665,90,221
0500000US46055,"Haakon County, South Dakota",909,695,7,512,176,214
0500000US46075,"Jones County, South Dakota",403,352,6,300,46,51
0500000US46093,"Meade County, South Dakota",10912,9668,31,8881,756,1244
0500000US46087,"McCook County, South Dakota",2209,1953,27,1687,239,256
0500000US46125,"Turner County, South Dakota",3470,2818,22,2478,318,652
0500000US46013,"Brown County, South Dakota",16184,13806,71,12380,1355,2378
0500000US46061,"Hanson County, South Dakota",1069,942,12,874,56,127
0500000US46095,"Mellette County, South Dakota",668,424,0,266,158,244
0500000US46105,"Perkins County, South Dakota",1285,1041,12,980,49,244
0500000US46103,"Pennington County, South Dakota",43598,38960,145,35271,3544,4638
0500000US46127,"Union County, South Dakota",6463,5682,43,5091,548,781
0500000US46097,"Miner County, South Dakota",973,823,11,732,80,150
0500000US46137,"Ziebach County, South Dakota",744,452,0,380,72,292
0500000US46039,"Deuel County, South Dakota",1799,1517,17,1349,151,282
0500000US46009,"Bon Homme County, South Dakota",2536,2046,16,1757,273,490
0500000US46015,"Brule County, South Dakota",2221,1676,22,1517,137,545
0500000US46047,"Fall River County, South Dakota",3119,2601,18,2349,234,518
0500000US46053,"Gregory County, South Dakota",1845,1447,4,1273,170,398
0500000US46102,"Oglala Lakota County, South Dakota",2820,1636,19,1332,285,1184
0500000US47119,"Maury County, Tennessee",33572,29850,130,26405,3315,3722
0500000US47173,"Union County, Tennessee",7126,5863,9,4417,1437,1263
0500000US47125,"Montgomery County, Tennessee",70303,64117,243,58595,5279,6186
0500000US47043,"Dickson County, Tennessee",18978,15183,120,13314,1749,3795
0500000US47129,"Morgan County, Tennessee",7517,5853,43,5050,760,1664
0500000US47061,"Grundy County, Tennessee",4838,3643,39,3068,536,1195
0500000US47123,"Monroe County, Tennessee",17694,13921,94,12257,1570,3773
0500000US47079,"Henry County, Tennessee",13406,11164,23,9518,1623,2242
0500000US47029,"Cocke County, Tennessee",14181,10370,81,8129,2160,3811
0500000US47033,"Crockett County, Tennessee",5335,4177,25,3533,619,1158
0500000US47041,"DeKalb County, Tennessee",7487,5800,90,5049,661,1687
0500000US47095,"Lake County, Tennessee",2203,1541,17,1317,207,662
0500000US47093,"Knox County, Tennessee",183318,163398,396,146351,16651,19920
0500000US47101,"Lewis County, Tennessee",4758,3383,49,2718,616,1375
0500000US47107,"McMinn County, Tennessee",20427,16139,145,13936,2058,4288
0500000US47117,"Marshall County, Tennessee",12335,10347,84,8557,1706,1988
0500000US47131,"Obion County, Tennessee",12715,10438,55,8881,1502,2277
0500000US47143,"Rhea County, Tennessee",12342,9774,40,8011,1723,2568
0500000US47151,"Scott County, Tennessee",8703,6662,49,5280,1333,2041
0500000US47167,"Tipton County, Tennessee",21325,18524,150,15747,2627,2801
0500000US47001,"Anderson County, Tennessee",30483,25431,159,23008,2264,5052
0500000US47045,"Dyer County, Tennessee",15180,12534,52,11205,1277,2646
0500000US47049,"Fentress County, Tennessee",7403,5599,38,4719,842,1804
0500000US47053,"Gibson County, Tennessee",19223,15697,98,13326,2273,3526
0500000US47065,"Hamilton County, Tennessee",140890,121197,307,109119,11771,19693
0500000US47105,"Loudon County, Tennessee",20215,17502,56,15313,2133,2713
0500000US47149,"Rutherford County, Tennessee",109468,102123,224,90539,11360,7345
0500000US47159,"Smith County, Tennessee",7584,6049,44,5353,652,1535
0500000US47189,"Wilson County, Tennessee",48841,44456,65,40625,3766,4385
0500000US47163,"Sullivan County, Tennessee",66239,56021,209,49656,6156,10218
0500000US47177,"Warren County, Tennessee",15655,12162,146,10572,1444,3493
0500000US47179,"Washington County, Tennessee",53190,46393,312,42151,3930,6797
0500000US47005,"Benton County, Tennessee",6786,5029,72,4045,912,1757
0500000US47013,"Campbell County, Tennessee",16172,11676,81,9322,2273,4496
0500000US47015,"Cannon County, Tennessee",5513,4481,36,3530,915,1032
0500000US47047,"Fayette County, Tennessee",15410,12759,45,10981,1733,2651
0500000US47067,"Hancock County, Tennessee",2809,1905,19,1200,686,904
0500000US47091,"Johnson County, Tennessee",6858,4991,139,3952,900,1867
0500000US47103,"Lincoln County, Tennessee",13636,10849,107,8494,2248,2787
0500000US47127,"Moore County, Tennessee",2602,2060,16,1587,457,542
0500000US47051,"Franklin County, Tennessee",16431,13686,153,11374,2159,2745
0500000US47009,"Blount County, Tennessee",50159,43465,148,38396,4921,6694
0500000US47099,"Lawrence County, Tennessee",16131,12622,63,10650,1909,3509
0500000US47019,"Carter County, Tennessee",23594,18085,299,14678,3108,5509
0500000US47057,"Grainger County, Tennessee",8948,7266,91,6292,883,1682
0500000US47097,"Lauderdale County, Tennessee",9754,7790,26,6523,1241,1964
0500000US47115,"Marion County, Tennessee",11582,9349,35,7862,1452,2233
0500000US47133,"Overton County, Tennessee",8974,6492,90,5571,831,2482
0500000US47165,"Sumner County, Tennessee",65645,58751,265,54023,4463,6894
0500000US47169,"Trousdale County, Tennessee",3054,2323,23,1907,393,731
0500000US47187,"Williamson County, Tennessee",75344,72290,113,69206,2971,3054
0500000US47027,"Clay County, Tennessee",3173,2254,28,1750,476,919
0500000US47059,"Greene County, Tennessee",27244,21630,310,18428,2892,5614
0500000US47157,"Shelby County, Tennessee",350260,291548,1261,251753,38534,58712
0500000US47175,"Van Buren County, Tennessee",2163,1589,23,1448,118,574
0500000US47077,"Henderson County, Tennessee",10671,8480,42,7146,1292,2191
0500000US47081,"Hickman County, Tennessee",8667,6125,80,4949,1096,2542
0500000US47089,"Jefferson County, Tennessee",19910,16934,19,14030,2885,2976
0500000US47153,"Sequatchie County, Tennessee",5441,4560,47,3806,707,881
0500000US47155,"Sevier County, Tennessee",36945,31616,181,27716,3719,5329
0500000US47017,"Carroll County, Tennessee",11062,8411,25,7295,1091,2651
0500000US47023,"Chester County, Tennessee",5958,4929,76,4203,650,1029
0500000US47037,"Davidson County, Tennessee",277903,252457,629,227158,24670,25446
0500000US47087,"Jackson County, Tennessee",4543,3270,37,2783,450,1273
0500000US47135,"Perry County, Tennessee",3317,2099,48,1797,254,1218
0500000US47145,"Roane County, Tennessee",20963,17090,34,14631,2425,3873
0500000US47121,"Meigs County, Tennessee",4790,3660,29,2943,688,1130
0500000US47063,"Hamblen County, Tennessee",24411,19760,63,16928,2769,4651
0500000US47075,"Haywood County, Tennessee",7100,5359,8,4258,1093,1741
0500000US48143,"Erath County, Texas",13961,12710,41,10326,2343,1251
0500000US48039,"Brazoria County, Texas",118762,109196,311,99572,9313,9566
0500000US48345,"Motley County, Texas",465,410,1,321,88,55
0500000US48129,"Donley County, Texas",1290,1014,4,779,231,276
0500000US48013,"Atascosa County, Texas",15387,13036,32,11725,1279,2351
0500000US48083,"Coleman County, Texas",3460,2843,45,2350,448,617
0500000US48353,"Nolan County, Texas",5469,4661,4,3777,880,808
0500000US48229,"Hudspeth County, Texas",900,646,0,405,241,254
0500000US48325,"Medina County, Texas",15470,12777,109,11249,1419,2693
0500000US48475,"Ward County, Texas",3956,3214,19,2666,529,742
0500000US48213,"Henderson County, Texas",30885,25325,254,22135,2936,5560
0500000US48203,"Harrison County, Texas",23217,18000,113,14714,3173,5217
0500000US48327,"Menard County, Texas",992,750,7,550,193,242
0500000US48277,"Lamar County, Texas",19313,15965,44,12651,3270,3348
0500000US48149,"Fayette County, Texas",9067,6767,176,5389,1202,2300
0500000US48491,"Williamson County, Texas",174754,167219,399,158544,8276,7535
0500000US48373,"Polk County, Texas",17803,14539,239,11684,2616,3264
0500000US48391,"Refugio County, Texas",2577,2032,8,1746,278,545
0500000US48055,"Caldwell County, Texas",13225,11028,85,8380,2563,2197
0500000US48487,"Wilbarger County, Texas",5263,4320,0,3599,721,943
0500000US48383,"Reagan County, Texas",1147,994,0,789,205,153
0500000US48189,"Hale County, Texas",11146,9313,34,8308,971,1833
0500000US48419,"Shelby County, Texas",9292,7447,140,5939,1368,1845
0500000US48399,"Runnels County, Texas",3749,2975,20,2490,465,774
0500000US48407,"San Jacinto County, Texas",9487,8185,45,6950,1190,1302
0500000US48451,"Tom Green County, Texas",43131,36899,145,31857,4897,6232
0500000US48469,"Victoria County, Texas",32544,27559,151,22363,5045,4985
0500000US48473,"Waller County, Texas",14807,13101,121,10021,2959,1706
0500000US48485,"Wichita County, Texas",47951,41401,164,35088,6149,6550
0500000US48493,"Wilson County, Texas",15820,14078,109,12735,1234,1742
0500000US48219,"Hockley County, Texas",7946,6663,69,5758,836,1283
0500000US48323,"Maverick County, Texas",16307,11660,0,9032,2628,4647
0500000US48147,"Fannin County, Texas",12231,10482,73,8420,1989,1749
0500000US48329,"Midland County, Texas",55980,51096,47,46146,4903,4884
0500000US48297,"Live Oak County, Texas",3675,2620,47,2080,493,1055
0500000US48299,"Llano County, Texas",8491,7352,75,6430,847,1139
0500000US48255,"Karnes County, Texas",4246,3052,38,2449,565,1194
0500000US48041,"Brazos County, Texas",79053,73725,93,63624,10008,5328
0500000US48067,"Cass County, Texas",11789,8635,30,7305,1300,3154
0500000US48165,"Gaines County, Texas",5737,4817,40,4273,504,920
0500000US48179,"Gray County, Texas",8000,6750,30,5712,1008,1250
0500000US48313,"Madison County, Texas",4201,3373,16,2778,579,828
0500000US48237,"Jack County, Texas",3160,2611,27,2046,538,549
0500000US48259,"Kendall County, Texas",14159,13354,138,12148,1068,805
0500000US48035,"Bosque County, Texas",7088,5992,77,4971,944,1096
0500000US48029,"Bexar County, Texas",632574,565106,1506,495066,68534,67468
0500000US48017,"Bailey County, Texas",2111,1865,3,1449,413,246
0500000US48023,"Baylor County, Texas",1474,1240,0,1106,134,234
0500000US48061,"Cameron County, Texas",123185,94662,342,64641,29679,28523
0500000US48121,"Denton County, Texas",283250,273301,543,254582,18176,9949
0500000US48477,"Washington County, Texas",12381,9796,121,8238,1437,2585
0500000US48343,"Morris County, Texas",5048,4106,10,3828,268,942
0500000US48429,"Stephens County, Texas",3268,2653,21,2285,347,615
0500000US48201,"Harris County, Texas",1583486,1423888,4015,1271537,148336,159598
0500000US48003,"Andrews County, Texas",5508,4957,13,4606,338,551
0500000US48171,"Gillespie County, Texas",10717,9077,33,8229,815,1640
0500000US48177,"Gonzales County, Texas",7214,5804,28,5056,720,1410
0500000US48305,"Lynn County, Texas",2133,1732,34,1456,242,401
0500000US48503,"Young County, Texas",7105,6140,88,5073,979,965
0500000US48505,"Zapata County, Texas",4405,3551,7,2327,1217,854
0500000US48221,"Hood County, Texas",21969,19849,88,17876,1885,2120
0500000US48223,"Hopkins County, Texas",13405,11692,110,10180,1402,1713
0500000US48357,"Ochiltree County, Texas",3443,3019,20,2442,557,424
0500000US48269,"King County, Texas",91,85,0,65,20,6
0500000US48275,"Knox County, Texas",1330,1064,2,909,153,266
0500000US48309,"McLennan County, Texas",89034,76947,422,64973,11552,12087
0500000US48073,"Cherokee County, Texas",17940,14927,114,12261,2552,3013
0500000US48095,"Concho County, Texas",873,676,8,608,60,197
0500000US48119,"Delta County, Texas",2015,1717,27,1394,296,298
0500000US48137,"Edwards County, Texas",686,430,0,304,126,256
0500000US48133,"Eastland County, Texas",6460,4838,83,4147,608,1622
0500000US48253,"Jones County, Texas",5593,4783,50,3910,823,810
0500000US48389,"Reeves County, Texas",3713,2853,27,2057,769,860
0500000US48403,"Sabine County, Texas",4099,3460,41,2951,468,639
0500000US48421,"Sherman County, Texas",1055,913,0,795,118,142
0500000US48437,"Swisher County, Texas",2514,2064,13,1868,183,450
0500000US48231,"Hunt County, Texas",32369,28079,214,23679,4186,4290
0500000US48063,"Camp County, Texas",4692,3721,38,2838,845,971
0500000US48195,"Hansford County, Texas",1855,1625,8,1353,264,230
0500000US48187,"Guadalupe County, Texas",53107,48380,160,44273,3947,4727
0500000US48077,"Clay County, Texas",4045,3450,9,2870,571,595
0500000US48217,"Hill County, Texas",12769,10776,80,9289,1407,1993
0500000US48347,"Nacogdoches County, Texas",23904,20561,161,17945,2455,3343
0500000US48369,"Parmer County, Texas",3318,2659,33,1988,638,659
0500000US48377,"Presidio County, Texas",2627,1653,0,1204,449,974
0500000US48465,"Val Verde County, Texas",15429,12450,3,10632,1815,2979
0500000US48135,"Ector County, Texas",51954,46060,86,41945,4029,5894
0500000US48173,"Glasscock County, Texas",432,377,6,301,70,55
0500000US48185,"Grimes County, Texas",8793,7133,57,5841,1235,1660
0500000US48085,"Collin County, Texas",331336,322549,504,302074,19971,8787
0500000US48005,"Angelina County, Texas",30783,27106,123,24282,2701,3677
0500000US48101,"Cottle County, Texas",686,517,2,445,70,169
0500000US48209,"Hays County, Texas",70881,66666,201,58455,8010,4215
0500000US48397,"Rockwall County, Texas",31649,30431,41,28808,1582,1218
0500000US48295,"Lipscomb County, Texas",1256,1114,6,994,114,142
0500000US48321,"Matagorda County, Texas",13636,10669,137,8151,2381,2967
0500000US48371,"Pecos County, Texas",4557,3531,14,2650,867,1026
0500000US48401,"Rusk County, Texas",17960,14552,240,10800,3512,3408
0500000US48447,"Throckmorton County, Texas",703,575,5,439,131,128
0500000US48471,"Walker County, Texas",21636,19430,89,16557,2784,2206
0500000US48499,"Wood County, Texas",16531,14104,113,12339,1652,2427
0500000US48007,"Aransas County, Texas",9432,8413,46,7462,905,1019
0500000US48075,"Childress County, Texas",2235,1712,0,1537,175,523
0500000US48081,"Coke County, Texas",1617,1391,0,1104,287,226
0500000US48099,"Coryell County, Texas",22314,20222,53,18601,1568,2092
0500000US48211,"Hemphill County, Texas",1323,1167,0,956,211,156
0500000US48341,"Moore County, Texas",6626,5743,2,5154,587,883
0500000US48349,"Navarro County, Texas",17397,14700,81,12184,2435,2697
0500000US48405,"San Augustine County, Texas",3356,2454,24,2156,274,902
0500000US48417,"Shackelford County, Texas",1234,914,2,847,65,320
0500000US48427,"Starr County, Texas",16238,12450,49,8476,3925,3788
0500000US48461,"Upton County, Texas",1305,1046,0,642,404,259
0500000US48021,"Bastrop County, Texas",25345,22456,94,20337,2025,2889
0500000US48191,"Hall County, Texas",1301,1014,12,764,238,287
0500000US48159,"Franklin County, Texas",3806,3375,13,2935,427,431
0500000US48163,"Frio County, Texas",4624,3451,18,2744,689,1173
0500000US48281,"Lampasas County, Texas",7738,6788,82,5793,913,950
0500000US48319,"Mason County, Texas",1667,1240,9,1032,199,427
0500000US48125,"Dickens County, Texas",842,715,4,616,95,127
0500000US48439,"Tarrant County, Texas",698995,650812,2444,585879,62489,48183
0500000US48001,"Anderson County, Texas",16459,13157,105,10801,2251,3302
0500000US48239,"Jackson County, Texas",5237,4412,13,3571,828,825
0500000US48331,"Milam County, Texas",9381,7407,90,5912,1405,1974
0500000US48093,"Comanche County, Texas",5260,4303,78,3430,795,957
0500000US48047,"Brooks County, Texas",2052,1535,0,1244,291,517
0500000US19029,"Cass County, Iowa",5964,5040,42,4259,739,924
0500000US19035,"Cherokee County, Iowa",5337,4536,36,4275,225,801
0500000US19047,"Crawford County, Iowa",6435,5280,59,4711,510,1155
0500000US19057,"Des Moines County, Iowa",16840,14220,85,12517,1618,2620
0500000US19065,"Fayette County, Iowa",8315,6952,133,6130,689,1363
0500000US19085,"Harrison County, Iowa",6076,5105,95,4302,708,971
0500000US19109,"Kossuth County, Iowa",6666,5662,45,4985,632,1004
0500000US19129,"Mills County, Iowa",5587,4938,80,4483,375,649
0500000US19133,"Monona County, Iowa",4053,3360,48,2963,349,693
0500000US19139,"Muscatine County, Iowa",16536,14059,98,12459,1502,2477
0500000US19143,"Osceola County, Iowa",2611,2263,32,2071,160,348
0500000US19153,"Polk County, Iowa",183753,169229,1123,152198,15908,14524
0500000US19187,"Webster County, Iowa",15208,12684,96,11321,1267,2524
0500000US19169,"Story County, Iowa",37219,35214,197,29806,5211,2005
0500000US19193,"Woodbury County, Iowa",38975,33580,291,29231,4058,5395
0500000US19013,"Black Hawk County, Iowa",52976,46150,287,41384,4479,6826
0500000US19075,"Grundy County, Iowa",5137,4409,45,4040,324,728
0500000US19097,"Jackson County, Iowa",8236,6737,71,6088,578,1499
0500000US19105,"Jones County, Iowa",8204,6799,85,6052,662,1405
0500000US19111,"Lee County, Iowa",14177,11895,95,10158,1642,2282
0500000US19131,"Mitchell County, Iowa",4397,3613,22,3327,264,784
0500000US19181,"Warren County, Iowa",18959,17258,129,15514,1615,1701
0500000US19161,"Sac County, Iowa",4367,3748,44,3298,406,619
0500000US19149,"Plymouth County, Iowa",10115,8890,69,8181,640,1225
0500000US19041,"Clay County, Iowa",7343,6495,20,5654,821,848
0500000US19045,"Clinton County, Iowa",19689,16259,137,14860,1262,3430
0500000US20183,"Smith County, Kansas",1681,1395,15,1279,101,286
0500000US20067,"Grant County, Kansas",2592,2292,3,2026,263,300
0500000US20095,"Kingman County, Kansas",3091,2605,25,2196,384,486
0500000US20015,"Butler County, Kansas",24473,21552,59,19642,1851,2921
0500000US20131,"Nemaha County, Kansas",4020,3367,11,2985,371,653
0500000US20149,"Pottawatomie County, Kansas",8695,7979,20,7185,774,716
0500000US20021,"Cherokee County, Kansas",8037,6697,90,5571,1036,1340
0500000US20105,"Lincoln County, Kansas",1264,1032,1,881,150,232
0500000US20191,"Sumner County, Kansas",9321,7958,84,6843,1031,1363
0500000US20195,"Trego County, Kansas",1380,1278,0,1187,91,102
0500000US20205,"Wilson County, Kansas",3795,3012,35,2378,599,783
0500000US20207,"Woodson County, Kansas",1476,1096,12,887,197,380
0500000US20135,"Ness County, Kansas",1313,1057,3,944,110,256
0500000US20141,"Osborne County, Kansas",1691,1401,19,1206,176,290
0500000US20011,"Bourbon County, Kansas",5722,4553,23,3833,697,1169
0500000US20075,"Hamilton County, Kansas",852,711,6,616,89,141
0500000US20097,"Kiowa County, Kansas",981,828,7,689,132,153
0500000US20177,"Shawnee County, Kansas",72017,62067,309,51806,9952,9950
0500000US20181,"Sherman County, Kansas",2649,2328,42,2201,85,321
0500000US20193,"Thomas County, Kansas",3301,3037,42,2710,285,264
0500000US20125,"Montgomery County, Kansas",13538,11382,71,9637,1674,2156
0500000US20127,"Morris County, Kansas",2247,1900,20,1712,168,347
0500000US20153,"Rawlins County, Kansas",1168,1009,2,915,92,159
0500000US20163,"Rooks County, Kansas",2100,1773,12,1531,230,327
0500000US20025,"Clark County, Kansas",893,709,5,576,128,184
0500000US20053,"Ellsworth County, Kansas",2462,2086,17,1796,273,376
0500000US20077,"Harper County, Kansas",2274,1888,15,1616,257,386
0500000US20167,"Russell County, Kansas",2979,2453,29,2269,155,526
0500000US20111,"Lyon County, Kansas",13584,12098,62,10775,1261,1486
0500000US20145,"Pawnee County, Kansas",2502,2030,5,1662,363,472
0500000US20001,"Allen County, Kansas",5289,4334,18,3797,519,955
0500000US20033,"Comanche County, Kansas",744,647,2,549,96,97
0500000US20049,"Elk County, Kansas",1117,873,9,718,146,244
0500000US20063,"Gove County, Kansas",1211,1029,5,912,112,182
0500000US20079,"Harvey County, Kansas",13383,11330,61,10438,831,2053
0500000US20083,"Hodgeman County, Kansas",761,682,7,592,83,79
0500000US20093,"Kearny County, Kansas",1261,1080,8,925,147,181
0500000US20185,"Stafford County, Kansas",1811,1496,12,1267,217,315
0500000US20113,"McPherson County, Kansas",12298,10844,32,9645,1167,1454
0500000US20139,"Osage County, Kansas",6554,5556,92,4817,647,998
0500000US20071,"Greeley County, Kansas",494,410,0,380,30,84
0500000US20031,"Coffey County, Kansas",3548,3074,21,2779,274,474
0500000US20037,"Crawford County, Kansas",15053,12981,45,11346,1590,2072
0500000US20051,"Ellis County, Kansas",11581,10200,23,9200,977,1381
0500000US20073,"Greenwood County, Kansas",2758,2165,23,1779,363,593
0500000US20099,"Labette County, Kansas",8033,6841,74,5833,934,1192
0500000US20107,"Linn County, Kansas",4348,3516,48,2473,995,832
0500000US20173,"Sedgwick County, Kansas",195779,171030,937,153912,16181,24749
0500000US20175,"Seward County, Kansas",7315,6234,28,5629,577,1081
0500000US20157,"Republic County, Kansas",2248,1765,25,1459,281,483
0500000US20065,"Graham County, Kansas",1216,1024,16,929,79,192
0500000US20091,"Johnson County, Kansas",226242,215183,520,205808,8855,11059
0500000US20045,"Douglas County, Kansas",46294,43614,151,39730,3733,2680
0500000US20179,"Sheridan County, Kansas",1134,978,13,867,98,156
0500000US20121,"Miami County, Kansas",12727,11269,220,9119,1930,1458
0500000US20069,"Gray County, Kansas",2179,1955,13,1660,282,224
0500000US20199,"Wallace County, Kansas",633,509,0,485,24,124
0500000US20189,"Stevens County, Kansas",1911,1703,5,1379,319,208
0500000US20201,"Washington County, Kansas",2344,1864,16,1604,244,480
0500000US20019,"Chautauqua County, Kansas",1450,1095,6,881,208,355
0500000US20129,"Morton County, Kansas",1117,911,0,785,126,206
0500000US20155,"Reno County, Kansas",25052,21634,110,19229,2295,3418
0500000US20029,"Cloud County, Kansas",3858,3225,15,2621,589,633
0500000US20171,"Scott County, Kansas",2025,1826,0,1755,71,199
0500000US20043,"Doniphan County, Kansas",3024,2327,52,1935,340,697
0500000US20081,"Haskell County, Kansas",1329,1141,13,993,135,188
0500000US20101,"Lane County, Kansas",787,701,6,635,60,86
0500000US20133,"Neosho County, Kansas",6681,5248,38,4528,682,1433
0500000US20013,"Brown County, Kansas",3904,3215,34,2826,355,689
0500000US20147,"Phillips County, Kansas",2363,2094,7,1893,194,269
0500000US20161,"Riley County, Kansas",26648,25122,57,23010,2055,1526
0500000US20039,"Decatur County, Kansas",1486,1291,6,1136,149,195
0500000US20087,"Jefferson County, Kansas",7600,6637,30,5901,706,963
0500000US21031,"Butler County, Kentucky",4996,3745,65,3134,546,1251
0500000US21061,"Edmonson County, Kentucky",4886,3860,86,3453,321,1026
0500000US21097,"Harrison County, Kentucky",7149,5557,68,4658,831,1592
0500000US21023,"Bracken County, Kentucky",3377,2736,92,2186,458,641
0500000US21143,"Lyon County, Kentucky",3258,2563,24,2160,379,695
0500000US21063,"Elliott County, Kentucky",2576,1876,0,1617,259,700
0500000US21111,"Jefferson County, Kentucky",310318,271048,589,246880,23579,39270
0500000US21123,"Larue County, Kentucky",5654,4801,14,3906,881,853
0500000US21161,"Mason County, Kentucky",6711,5100,1,4617,482,1611
0500000US21167,"Mercer County, Kentucky",8571,6956,37,6187,732,1615
0500000US21201,"Robertson County, Kentucky",902,598,10,434,154,304
0500000US21207,"Russell County, Kentucky",7027,5086,162,4219,705,1941
0500000US21229,"Washington County, Kentucky",4667,3740,45,3072,623,927
0500000US21007,"Ballard County, Kentucky",3085,2443,19,2153,271,642
0500000US21009,"Barren County, Kentucky",16965,14027,127,12787,1113,2938
0500000US21087,"Green County, Kentucky",4466,3364,29,2873,462,1102
0500000US21091,"Hancock County, Kentucky",3301,2728,24,2455,249,573
0500000US21159,"Martin County, Kentucky",4112,3004,24,2742,238,1108
0500000US21093,"Hardin County, Kentucky",41111,36559,262,31339,4958,4552
0500000US21149,"McLean County, Kentucky",3818,3173,15,2638,520,645
0500000US21183,"Ohio County, Kentucky",9076,7154,67,6168,919,1922
0500000US21197,"Powell County, Kentucky",4831,3575,37,2910,628,1256
0500000US21233,"Webster County, Kentucky",4975,3790,30,3090,670,1185
0500000US21033,"Caldwell County, Kentucky",5176,4360,32,3771,557,816
0500000US21045,"Casey County, Kentucky",6330,4758,30,4139,589,1572
0500000US21047,"Christian County, Kentucky",25682,21385,235,18222,2928,4297
0500000US21085,"Grayson County, Kentucky",9771,8000,50,6199,1751,1771
0500000US21103,"Henry County, Kentucky",5999,4914,11,4035,868,1085
0500000US21107,"Hopkins County, Kentucky",18560,14719,216,12742,1761,3841
0500000US21109,"Jackson County, Kentucky",5455,4237,57,3457,723,1218
0500000US21125,"Laurel County, Kentucky",22735,18238,267,16165,1806,4497
0500000US21157,"Marshall County, Kentucky",13390,11501,52,10278,1171,1889
0500000US21163,"Meade County, Kentucky",10638,9368,82,8807,479,1270
0500000US21173,"Montgomery County, Kentucky",10472,8788,36,7327,1425,1684
0500000US21181,"Nicholas County, Kentucky",2694,1951,41,1592,318,743
0500000US21185,"Oldham County, Kentucky",20733,19673,46,18648,979,1060
0500000US21187,"Owen County, Kentucky",3921,2953,0,2249,704,968
0500000US21203,"Rockcastle County, Kentucky",6525,4949,104,4113,732,1576
0500000US21209,"Scott County, Kentucky",20206,18466,73,16704,1689,1740
0500000US21227,"Warren County, Kentucky",47142,41914,141,38188,3585,5228
0500000US21003,"Allen County, Kentucky",7697,6250,86,4987,1177,1447
0500000US21017,"Bourbon County, Kentucky",8128,6658,35,5498,1125,1470
0500000US21019,"Boyd County, Kentucky",18798,16217,129,14352,1736,2581
0500000US21029,"Bullitt County, Kentucky",29374,26255,214,23668,2373,3119
0500000US21055,"Crittenden County, Kentucky",3645,2751,42,2178,531,894
0500000US21067,"Fayette County, Kentucky",128806,118814,310,107994,10510,9992
0500000US21075,"Fulton County, Kentucky",2524,1925,0,1526,399,599
0500000US21115,"Johnson County, Kentucky",8737,7010,30,6375,605,1727
0500000US21165,"Menifee County, Kentucky",2593,1906,25,1654,227,687
0500000US21051,"Clay County, Kentucky",7625,5799,26,5138,635,1826
0500000US21175,"Morgan County, Kentucky",4958,3599,0,3305,294,1359
0500000US21193,"Perry County, Kentucky",11172,8598,20,7755,823,2574
0500000US21237,"Wolfe County, Kentucky",2817,1824,18,1537,269,993
0500000US21013,"Bell County, Kentucky",10940,7749,4,6570,1175,3191
0500000US21025,"Breathitt County, Kentucky",5322,3791,24,3148,619,1531
0500000US21083,"Graves County, Kentucky",14484,11460,19,9843,1598,3024
0500000US21099,"Hart County, Kentucky",7311,5388,80,4784,524,1923
0500000US21231,"Wayne County, Kentucky",8019,5308,8,4604,696,2711
0500000US21155,"Marion County, Kentucky",7453,5720,57,4766,897,1733
0500000US21221,"Trigg County, Kentucky",5970,4745,33,4010,702,1225
0500000US21015,"Boone County, Kentucky",46404,43555,183,41145,2227,2849
0500000US21131,"Leslie County, Kentucky",4223,3060,12,2580,468,1163
0500000US21121,"Knox County, Kentucky",12270,8128,45,6373,1710,4142
0500000US21127,"Lawrence County, Kentucky",5956,4366,31,3722,613,1590
0500000US21139,"Livingston County, Kentucky",3967,3226,58,2586,582,741
0500000US21195,"Pike County, Kentucky",25768,20942,55,18113,2774,4826
0500000US21211,"Shelby County, Kentucky",16569,14461,65,12741,1655,2108
0500000US21005,"Anderson County, Kentucky",8627,7598,15,6447,1136,1029
0500000US21027,"Breckinridge County, Kentucky",7675,5936,57,5252,627,1739
0500000US21073,"Franklin County, Kentucky",20875,18404,13,16394,1997,2471
0500000US21117,"Kenton County, Kentucky",63529,56913,268,52351,4294,6616
0500000US21151,"Madison County, Kentucky",33229,29538,180,25650,3708,3691
0500000US21153,"Magoffin County, Kentucky",5084,3798,7,3326,465,1286
0500000US21189,"Owsley County, Kentucky",1664,1169,5,1008,156,495
0500000US21213,"Simpson County, Kentucky",6914,5372,31,4765,576,1542
0500000US21217,"Taylor County, Kentucky",9596,7713,59,7096,558,1883
0500000US21219,"Todd County, Kentucky",4663,3184,47,2555,582,1479
0500000US21039,"Carlisle County, Kentucky",2020,1628,7,1429,192,392
0500000US21053,"Clinton County, Kentucky",3835,2490,132,1931,427,1345
0500000US21077,"Gallatin County, Kentucky",3073,2499,14,1993,492,574
0500000US21079,"Garrard County, Kentucky",6823,5723,80,4989,654,1100
0500000US21069,"Fleming County, Kentucky",5888,4562,23,4033,506,1326
0500000US21037,"Campbell County, Kentucky",36308,32399,694,28560,3145,3909
0500000US22113,"Vermilion Parish, Louisiana",21632,17690,37,15940,1713,3942
0500000US22089,"St. Charles Parish, Louisiana",18762,16712,23,15056,1633,2050
0500000US22029,"Concordia Parish, Louisiana",7371,5089,18,4252,819,2282
0500000US22107,"Tensas Parish, Louisiana",1825,943,35,739,169,882
0500000US22093,"St. James Parish, Louisiana",7906,6386,33,5485,868,1520
0500000US22043,"Grant Parish, Louisiana",6989,5287,21,4142,1124,1702
0500000US22051,"Jefferson Parish, Louisiana",168895,143815,492,125922,17401,25080
0500000US22013,"Bienville Parish, Louisiana",5892,4343,39,3648,656,1549
0500000US22015,"Bossier Parish, Louisiana",48947,42461,267,32422,9772,6486
0500000US22023,"Cameron Parish, Louisiana",2718,2230,0,1895,335,488
0500000US22037,"East Feliciana Parish, Louisiana",6759,5339,16,3931,1392,1420
0500000US22095,"St. John the Baptist Parish, Louisiana",15418,13242,20,10999,2223,2176
0500000US22075,"Plaquemines Parish, Louisiana",8817,7565,38,6691,836,1252
0500000US22073,"Ouachita Parish, Louisiana",56686,44807,747,39222,4838,11879
0500000US22079,"Rapides Parish, Louisiana",48000,40336,130,35912,4294,7664
0500000US22117,"Washington Parish, Louisiana",17337,13006,97,10165,2744,4331
0500000US22097,"St. Landry Parish, Louisiana",30094,22653,378,18365,3910,7441
0500000US22105,"Tangipahoa Parish, Louisiana",47527,40827,127,35820,4880,6700
0500000US22001,"Acadia Parish, Louisiana",22564,18174,64,15799,2311,4390
0500000US22101,"St. Mary Parish, Louisiana",19740,15693,61,13300,2332,4047
0500000US22123,"West Carroll Parish, Louisiana",4041,2416,116,1748,552,1625
0500000US22103,"St. Tammany Parish, Louisiana",91975,84199,248,77594,6357,7776
0500000US22111,"Union Parish, Louisiana",7724,5161,228,3869,1064,2563
0500000US22021,"Caldwell Parish, Louisiana",3667,2461,8,2139,314,1206
0500000US22055,"Lafayette Parish, Louisiana",90606,80438,169,74419,5850,10168
0500000US22017,"Caddo Parish, Louisiana",96360,79611,441,65425,13745,16749
0500000US22035,"East Carroll Parish, Louisiana",2153,854,10,687,157,1299
0500000US22005,"Ascension Parish, Louisiana",42649,38870,175,35989,2706,3779
0500000US22045,"Iberia Parish, Louisiana",26063,21520,49,18581,2890,4543
0500000US22087,"St. Bernard Parish, Louisiana",15029,12712,43,10753,1916,2317
0500000US22091,"St. Helena Parish, Louisiana",3871,2929,15,2163,751,942
0500000US22121,"West Baton Rouge Parish, Louisiana",9599,8482,8,7256,1218,1117
0500000US22031,"De Soto Parish, Louisiana",10523,8548,90,6819,1639,1975
0500000US22081,"Red River Parish, Louisiana",3334,2557,63,2132,362,777
0500000US22063,"Livingston Parish, Louisiana",48859,43910,164,37986,5760,4949
0500000US22069,"Natchitoches Parish, Louisiana",14630,9676,112,8107,1457,4954
0500000US22071,"Orleans Parish, Louisiana",154036,126064,397,105935,19732,27972
0500000US22025,"Catahoula Parish, Louisiana",3595,2484,4,2004,476,1111
0500000US22019,"Calcasieu Parish, Louisiana",77295,65915,101,55747,10067,11380
0500000US22041,"Franklin Parish, Louisiana",7629,5107,48,3478,1581,2522
0500000US22007,"Assumption Parish, Louisiana",8802,6744,52,5731,961,2058
0500000US22049,"Jackson Parish, Louisiana",5976,4564,0,4118,446,1412
0500000US22083,"Richland Parish, Louisiana",7391,4925,107,3544,1274,2466
0500000US22099,"St. Martin Parish, Louisiana",19556,16149,48,13935,2166,3407
0500000US22127,"Winn Parish, Louisiana",5437,4085,22,3679,384,1352
0500000US22033,"East Baton Rouge Parish, Louisiana",165939,146239,313,131586,14340,19700
0500000US22003,"Allen Parish, Louisiana",7920,6355,35,5444,876,1565
0500000US22065,"Madison Parish, Louisiana",3943,2386,31,1742,613,1557
0500000US23017,"Oxford County, Maine",20814,17589,255,15211,2123,3225
0500000US23027,"Waldo County, Maine",17067,14909,220,13116,1573,2158
0500000US23019,"Penobscot County, Maine",61578,54267,663,48204,5400,7311
0500000US23001,"Androscoggin County, Maine",45491,40002,320,35758,3924,5489
0500000US23003,"Aroostook County, Maine",29645,24022,300,20307,3415,5623
0500000US23005,"Cumberland County, Maine",119717,110071,747,102358,6966,9646
0500000US23013,"Knox County, Maine",17156,15420,208,13821,1391,1736
0500000US23031,"York County, Maine",84648,76529,689,70391,5449,8119
0500000US23007,"Franklin County, Maine",11817,10229,103,8876,1250,1588
0500000US23025,"Somerset County, Maine",21533,17802,207,15500,2095,3731
0500000US24047,"Worcester County, Maryland",21672,18872,98,17133,1641,2800
0500000US24510,"Baltimore city, Maryland",238436,200312,1073,170251,28988,38124
0500000US24041,"Talbot County, Maryland",16627,15039,63,13719,1257,1588
0500000US24025,"Harford County, Maryland",93286,85862,347,80274,5241,7424
0500000US24027,"Howard County, Maryland",112966,108989,187,104972,3830,3977
0500000US24003,"Anne Arundel County, Maryland",207599,194294,375,184524,9395,13305
0500000US24005,"Baltimore County, Maryland",312913,283539,1114,263144,19281,29374
0500000US24009,"Calvert County, Maryland",31726,29444,125,27791,1528,2282
0500000US24023,"Garrett County, Maryland",12073,9977,136,8705,1136,2096
0500000US24031,"Montgomery County, Maryland",370227,354046,997,334266,18783,16181
0500000US24013,"Carroll County, Maryland",60450,55080,400,51259,3421,5370
0500000US24035,"Queen Anne's County, Maryland",18148,16732,77,15621,1034,1416
0500000US24037,"St. Mary's County, Maryland",40332,36367,269,32819,3279,3965
0500000US24017,"Charles County, Maryland",55903,50679,253,47505,2921,5224
0500000US24019,"Dorchester County, Maryland",13264,11009,128,9624,1257,2255
0500000US24043,"Washington County, Maryland",55864,47069,437,41231,5401,8795
0500000US24045,"Wicomico County, Maryland",37637,33275,229,28618,4428,4362
0500000US24015,"Cecil County, Maryland",36930,32394,133,29310,2951,4536
0500000US24011,"Caroline County, Maryland",12081,10222,44,9193,985,1859
0500000US25025,"Suffolk County, Massachusetts",307870,274447,879,252124,21444,33423
0500000US25001,"Barnstable County, Massachusetts",94292,86682,441,80224,6017,7610
0500000US25007,"Dukes County, Massachusetts",6367,5850,7,4947,896,517
0500000US25017,"Middlesex County, Massachusetts",600032,552993,1549,525644,25800,47039
0500000US25003,"Berkshire County, Massachusetts",55167,48193,456,44103,3634,6974
0500000US25009,"Essex County, Massachusetts",292659,262628,899,244131,17598,30031
0500000US25005,"Bristol County, Massachusetts",216618,187743,777,171108,15858,28875
0500000US25013,"Hampden County, Massachusetts",179043,152039,898,136364,14777,27004
0500000US25023,"Plymouth County, Massachusetts",186306,171418,454,160820,10144,14888
0500000US25011,"Franklin County, Massachusetts",30328,26749,298,24001,2450,3579
0500000US25021,"Norfolk County, Massachusetts",263551,243979,648,232189,11142,19572
0500000US25015,"Hampshire County, Massachusetts",58665,53671,334,50320,3017,4994
0500000US25019,"Nantucket County, Massachusetts",3722,3581,6,3419,156,141
0500000US26115,"Monroe County, Michigan",59279,52401,401,46877,5123,6878
0500000US26005,"Allegan County, Michigan",43000,36231,266,32274,3691,6769
0500000US26059,"Hillsdale County, Michigan",17904,14442,168,12549,1725,3462
0500000US26003,"Alger County, Michigan",3094,2522,45,2172,305,572
0500000US26127,"Oceana County, Michigan",10157,8611,95,6978,1538,1546
0500000US26089,"Leelanau County, Michigan",9152,8298,53,7597,648,854
0500000US26035,"Clare County, Michigan",12406,10016,47,8327,1642,2390
0500000US26083,"Keweenaw County, Michigan",1081,869,6,719,144,212
0500000US26073,"Isabella County, Michigan",24889,22486,112,18088,4286,2403
0500000US26139,"Ottawa County, Michigan",101223,92698,530,85231,6937,8525
0500000US26157,"Tuscola County, Michigan",21759,18438,233,15451,2754,3321
0500000US26007,"Alpena County, Michigan",12717,10544,86,9321,1137,2173
0500000US26067,"Ionia County, Michigan",22858,20313,165,17556,2592,2545
0500000US26111,"Midland County, Michigan",34017,29814,307,27085,2422,4203
0500000US26021,"Berrien County, Michigan",63908,54988,411,46396,8181,8920
0500000US26135,"Oscoda County, Michigan",3824,2875,90,2362,423,949
0500000US26039,"Crawford County, Michigan",6047,5259,44,4699,516,788
0500000US26037,"Clinton County, Michigan",29421,26708,279,24621,1808,2713
0500000US26057,"Gratiot County, Michigan",15177,12691,116,10203,2372,2486
0500000US26063,"Huron County, Michigan",13918,11385,66,9584,1735,2533
0500000US26091,"Lenawee County, Michigan",38222,33981,276,30131,3574,4241
0500000US26105,"Mason County, Michigan",12115,10392,102,8797,1493,1723
0500000US26117,"Montcalm County, Michigan",23761,19410,197,16290,2923,4351
0500000US26149,"St. Joseph County, Michigan",24022,20257,180,17733,2344,3765
0500000US26147,"St. Clair County, Michigan",64805,57120,501,51807,4812,7685
0500000US26161,"Washtenaw County, Michigan",140210,131786,420,121959,9407,8424
0500000US26011,"Arenac County, Michigan",6684,5232,76,4351,805,1452
0500000US26027,"Cass County, Michigan",20855,18390,178,15725,2487,2465
0500000US26071,"Iron County, Michigan",5327,4230,68,3248,914,1097
0500000US26143,"Roscommon County, Michigan",10899,9154,64,8186,904,1745
0500000US26163,"Wayne County, Michigan",676587,578821,2572,481314,94935,97766
0500000US26023,"Branch County, Michigan",16506,14080,149,12243,1688,2426
0500000US26075,"Jackson County, Michigan",61696,53971,329,47576,6066,7725
0500000US26097,"Mackinac County, Michigan",5284,4416,61,3686,669,868
0500000US26009,"Antrim County, Michigan",9805,8654,63,7426,1165,1151
0500000US26061,"Houghton County, Michigan",13340,11390,56,10198,1136,1950
0500000US26069,"Iosco County, Michigan",11631,9649,147,8635,867,1982
0500000US26085,"Lake County, Michigan",4517,3398,41,2683,674,1119
0500000US26119,"Montmorency County, Michigan",4195,3412,61,2892,459,783
0500000US26141,"Presque Isle County, Michigan",5808,4667,116,3888,663,1141
0500000US26077,"Kalamazoo County, Michigan",102809,93539,404,86558,6577,9270
0500000US26107,"Mecosta County, Michigan",15858,13549,180,11469,1900,2309
0500000US26103,"Marquette County, Michigan",26203,22856,105,19954,2797,3347
0500000US26123,"Newaygo County, Michigan",19007,15821,210,12787,2824,3186
0500000US26133,"Osceola County, Michigan",9100,7371,78,5858,1435,1729
0500000US26137,"Otsego County, Michigan",9886,8756,97,7720,939,1130
0500000US26025,"Calhoun County, Michigan",53659,45749,355,40280,5114,7910
0500000US26031,"Cheboygan County, Michigan",11201,9406,135,7946,1325,1795
0500000US26095,"Luce County, Michigan",2190,1750,43,1514,193,440
0500000US26081,"Kent County, Michigan",239236,217019,900,200007,16112,22217
0500000US26099,"Macomb County, Michigan",343592,305710,826,284342,20542,37882
0500000US26017,"Bay County, Michigan",43891,37324,216,34091,3017,6567
0500000US26145,"Saginaw County, Michigan",78648,65496,345,59047,6104,13152
0500000US26155,"Shiawassee County, Michigan",27741,24114,178,21370,2566,3627
0500000US26013,"Baraga County, Michigan",3036,2424,54,2137,233,612
0500000US26029,"Charlevoix County, Michigan",11379,10077,70,8716,1291,1302
0500000US26045,"Eaton County, Michigan",44390,40063,220,35947,3896,4327
0500000US26041,"Delta County, Michigan",15949,13236,97,11588,1551,2713
0500000US26053,"Gogebic County, Michigan",6619,5148,67,4068,1013,1471
0500000US26047,"Emmet County, Michigan",14510,12811,109,11425,1277,1699
0500000US05147,"Woodruff County, Arkansas",2890,1823,2,1558,263,1067
0500000US05023,"Cleburne County, Arkansas",10731,8846,46,7468,1332,1885
0500000US05025,"Cleveland County, Arkansas",3292,2566,37,1814,715,726
0500000US05067,"Jackson County, Arkansas",6095,4482,16,3744,722,1613
0500000US05057,"Hempstead County, Arkansas",7971,6231,24,5334,873,1740
0500000US05135,"Sharp County, Arkansas",7354,5915,35,4213,1667,1439
0500000US05137,"Stone County, Arkansas",4954,3774,52,2300,1422,1180
0500000US05143,"Washington County, Arkansas",85891,78127,427,65708,11992,7764
0500000US05005,"Baxter County, Arkansas",18370,15352,255,12925,2172,3018
0500000US05003,"Ashley County, Arkansas",7915,6003,22,4704,1277,1912
0500000US05031,"Craighead County, Arkansas",40800,36410,51,31803,4556,4390
0500000US05055,"Greene County, Arkansas",16879,14378,45,12541,1792,2501
0500000US05073,"Lafayette County, Arkansas",2859,1969,43,1553,373,890
0500000US05105,"Perry County, Arkansas",3708,2954,3,2430,521,754
0500000US05107,"Phillips County, Arkansas",7498,5362,24,4512,826,2136
0500000US05111,"Poinsett County, Arkansas",9437,7538,66,6549,923,1899
0500000US05133,"Sevier County, Arkansas",5854,4796,21,4108,667,1058
0500000US05149,"Yell County, Arkansas",7491,5736,49,4927,760,1755
0500000US05013,"Calhoun County, Arkansas",1936,1443,24,1130,289,493
0500000US05019,"Clark County, Arkansas",8505,6968,16,5698,1254,1537
0500000US05011,"Bradley County, Arkansas",4537,3527,22,2806,699,1010
0500000US05095,"Monroe County, Arkansas",3326,2394,15,1795,584,932
0500000US05113,"Polk County, Arkansas",8204,6628,65,5092,1471,1576
0500000US05103,"Ouachita County, Arkansas",10055,7110,73,5956,1081,2945
0500000US05101,"Newton County, Arkansas",2899,2117,8,1708,401,782
0500000US05081,"Little River County, Arkansas",5440,4404,134,3382,888,1036
0500000US05015,"Carroll County, Arkansas",11161,9272,140,7253,1879,1889
0500000US05091,"Miller County, Arkansas",16748,14029,70,11942,2017,2719
0500000US06033,"Lake County, California",25966,21733,143,18675,2915,4233
0500000US06043,"Mariposa County, California",7700,6710,163,5817,730,990
0500000US06115,"Yuba County, California",26179,23373,141,20909,2323,2806
0500000US06013,"Contra Costa County, California",392277,370116,949,352003,17164,22161
0500000US06035,"Lassen County, California",9493,7990,103,7153,734,1503
0500000US06083,"Santa Barbara County, California",144962,132496,836,122994,8666,12466
0500000US06097,"Sonoma County, California",189339,176225,1042,163836,11347,13114
0500000US06025,"Imperial County, California",44057,37309,239,32215,4855,6748
0500000US06051,"Mono County, California",4847,4428,35,4036,357,419
0500000US06001,"Alameda County, California",572870,535962,1717,498861,35384,36908
0500000US06067,"Sacramento County, California",536029,499475,2117,456573,40785,36554
0500000US06055,"Napa County, California",49032,45419,188,42598,2633,3613
0500000US06053,"Monterey County, California",126052,110447,383,101033,9031,15605
0500000US06091,"Sierra County, California",1241,979,4,909,66,262
0500000US06073,"San Diego County, California",1118980,1051246,2696,988501,60049,67734
0500000US06113,"Yolo County, California",73510,68507,267,63330,4910,5003
0500000US06023,"Humboldt County, California",54267,48738,230,43696,4812,5529
0500000US06003,"Alpine County, California",299,272,0,254,18,27
0500000US06045,"Mendocino County, California",34090,29268,420,26251,2597,4822
0500000US06087,"Santa Cruz County, California",95756,87694,255,82156,5283,8062
0500000US06037,"Los Angeles County, California",3306109,2989974,11780,2695212,282982,316135
0500000US06065,"Riverside County, California",718349,657216,2745,603261,51210,61133
0500000US06085,"Santa Clara County, California",635525,605466,1933,573891,29642,30059
0500000US06041,"Marin County, California",105258,99111,303,94843,3965,6147
0500000US06093,"Siskiyou County, California",19257,16453,143,14902,1408,2804
0500000US06089,"Shasta County, California",70473,62041,490,55238,6313,8432
0500000US06015,"Del Norte County, California",9799,8571,37,7483,1051,1228
0500000US06079,"San Luis Obispo County, California",105317,97444,595,90319,6530,7873
0500000US06021,"Glenn County, California",10017,8341,66,6971,1304,1676
0500000US06007,"Butte County, California",86797,78815,554,71815,6446,7982
0500000US06063,"Plumas County, California",8047,6778,75,6070,633,1269
0500000US06029,"Kern County, California",267913,228712,1207,203831,23674,39201
0500000US06059,"Orange County, California",1032373,974586,4751,917763,52072,57787
0500000US06009,"Calaveras County, California",17417,15073,300,13518,1255,2344
0500000US06101,"Sutter County, California",32360,28723,146,26346,2231,3637
0500000US06081,"San Mateo County, California",261969,247758,740,233925,13093,14211
0500000US06109,"Tuolumne County, California",22427,19920,172,17455,2293,2507
0500000US06077,"San Joaquin County, California",226727,201039,1641,179790,19608,25688
0500000US06005,"Amador County, California",14090,12577,178,11378,1021,1513
0500000US08095,"Phillips County, Colorado",1668,1526,20,1315,191,142
0500000US08007,"Archuleta County, Colorado",5670,5197,28,4589,580,473
0500000US08031,"Denver County, Colorado",294358,270265,1146,245165,23954,24093
0500000US08061,"Kiowa County, Colorado",593,517,0,482,35,76
0500000US08055,"Huerfano County, Colorado",3282,2498,41,2018,439,784
0500000US08009,"Baca County, Colorado",1642,1322,4,1132,186,320
0500000US08015,"Chaffee County, Colorado",7958,7051,76,6475,500,907
0500000US08047,"Gilpin County, Colorado",2653,2561,19,2275,267,92
0500000US08063,"Kit Carson County, Colorado",2977,2501,13,2304,184,476
0500000US08045,"Garfield County, Colorado",21138,19588,188,17475,1925,1550
0500000US08051,"Gunnison County, Colorado",6643,6265,95,5481,689,378
0500000US08059,"Jefferson County, Colorado",230153,216387,1338,202515,12534,13766
0500000US08079,"Mineral County, Colorado",375,339,3,291,45,36
0500000US08091,"Ouray County, Colorado",2194,2035,21,1803,211,159
0500000US08103,"Rio Blanco County, Colorado",2403,2120,16,1850,254,283
0500000US08115,"Sedgwick County, Colorado",1017,845,21,699,125,172
0500000US08021,"Conejos County, Colorado",3068,2231,25,1911,295,837
0500000US08023,"Costilla County, Colorado",1687,1153,24,987,142,534
0500000US08001,"Adams County, Colorado",164353,151894,768,134208,16918,12459
0500000US08037,"Eagle County, Colorado",17750,17095,144,15666,1285,655
0500000US08065,"Lake County, Colorado",3353,2851,0,2510,341,502
0500000US08081,"Moffat County, Colorado",5210,4686,20,4139,527,524
0500000US08097,"Pitkin County, Colorado",7018,6642,109,6216,317,376
0500000US08017,"Cheyenne County, Colorado",742,636,3,583,50,106
0500000US08025,"Crowley County, Colorado",1194,992,12,894,86,202
0500000US08033,"Dolores County, Colorado",740,610,21,479,110,130
0500000US08057,"Jackson County, Colorado",575,471,0,432,39,104
0500000US08069,"Larimer County, Colorado",133527,127107,818,117001,9288,6420
0500000US08083,"Montezuma County, Colorado",10615,9022,125,7167,1730,1593
0500000US08113,"San Miguel County, Colorado",3441,3283,40,2764,479,158
0500000US08013,"Boulder County, Colorado",125894,120276,306,112506,7464,5618
0500000US08071,"Las Animas County, Colorado",6477,5182,48,4430,704,1295
0500000US08125,"Yuma County, Colorado",4051,3482,33,2965,484,569
0500000US08107,"Routt County, Colorado",9552,9038,22,8705,311,514
0500000US08117,"Summit County, Colorado",9707,9402,63,8021,1318,305
0500000US08019,"Clear Creek County, Colorado",4640,4366,59,3866,441,274
0500000US08029,"Delta County, Colorado",11882,9788,197,8392,1199,2094
0500000US08101,"Pueblo County, Colorado",63762,54881,477,46238,8166,8881
0500000US08087,"Morgan County, Colorado",10785,9176,74,8444,658,1609
0500000US08093,"Park County, Colorado",7119,6536,35,5823,678,583
0500000US08077,"Mesa County, Colorado",61033,55200,418,50764,4018,5833
0500000US08099,"Prowers County, Colorado",4963,4092,5,3726,361,871
0500000US08041,"El Paso County, Colorado",253379,237779,1191,225054,11534,15600
0500000US08121,"Washington County, Colorado",2030,1778,21,1561,196,252
0500000US08005,"Arapahoe County, Colorado",237559,224794,1210,208496,15088,12765
0500000US08014,"Broomfield County, Colorado",26721,25879,89,24616,1174,842
0500000US09009,"New Haven County, Connecticut",329857,288626,1575,264042,23009,41231
0500000US09013,"Tolland County, Connecticut",55232,50954,220,47870,2864,4278
0500000US09003,"Hartford County, Connecticut",349064,309451,1452,283992,24007,39613
0500000US09015,"Windham County, Connecticut",44449,39040,205,35387,3448,5409
0500000US09007,"Middlesex County, Connecticut",66892,60654,213,56713,3728,6238
0500000US10003,"New Castle County, Delaware",203855,185239,692,169408,15139,18616
0500000US10005,"Sussex County, Delaware",89365,78370,372,69575,8423,10995
0500000US11001,"District of Columbia, District of Columbia",281322,252564,640,223102,28822,28758
0500000US12091,"Okaloosa County, Florida",77403,70726,337,62960,7429,6677
0500000US12123,"Taylor County, Florida",7356,5937,115,4668,1154,1419
0500000US12133,"Washington County, Florida",8484,7076,95,6145,836,1408
0500000US12031,"Duval County, Florida",354387,316855,1177,285622,30056,37532
0500000US12007,"Bradford County, Florida",8993,6579,55,5821,703,2414
0500000US12009,"Brevard County, Florida",228888,207904,1112,193148,13644,20984
0500000US12019,"Clay County, Florida",73398,69119,407,64247,4465,4279
0500000US12067,"Lafayette County, Florida",2095,1681,13,1448,220,414
0500000US12069,"Lake County, Florida",130190,117187,774,108018,8395,13003
0500000US12089,"Nassau County, Florida",31241,28909,324,26146,2439,2332
0500000US12103,"Pinellas County, Florida",407720,359544,1546,324621,33377,48176
0500000US12105,"Polk County, Florida",231260,197786,999,152529,44258,33474
0500000US12111,"St. Lucie County, Florida",112872,101480,553,92063,8864,11392
0500000US12043,"Glades County, Florida",4433,3114,24,2440,650,1319
0500000US12051,"Hendry County, Florida",12027,8936,12,7700,1224,3091
0500000US12061,"Indian River County, Florida",57403,49783,279,45758,3746,7620
0500000US12063,"Jackson County, Florida",16894,13036,131,11648,1257,3858
0500000US12099,"Palm Beach County, Florida",548216,498313,2186,452625,43502,49903
0500000US12109,"St. Johns County, Florida",86268,80691,500,73960,6231,5577
0500000US12117,"Seminole County, Florida",167304,158331,459,148742,9130,8973
0500000US12086,"Miami-Dade County, Florida",870051,763358,2208,648026,113124,106693
0500000US12005,"Bay County, Florida",70199,63125,192,57468,5465,7074
0500000US12035,"Flagler County, Florida",40629,36403,167,31572,4664,4226
0500000US12037,"Franklin County, Florida",4297,3564,67,3156,341,733
0500000US12047,"Hamilton County, Florida",4485,3528,90,2838,600,957
0500000US12077,"Liberty County, Florida",2381,1779,32,1443,304,602
0500000US12119,"Sumter County, Florida",54636,49685,609,45365,3711,4951
0500000US12039,"Gadsden County, Florida",17080,12453,44,9905,2504,4627
0500000US12059,"Holmes County, Florida",7016,5581,68,4912,601,1435
0500000US12071,"Lee County, Florida",271861,248700,2330,221529,24841,23161
0500000US12083,"Marion County, Florida",136514,116094,1338,104520,10236,20420
0500000US12021,"Collier County, Florida",140942,129909,630,115883,13396,11033
0500000US12095,"Orange County, Florida",458613,427886,928,389441,37517,30727
0500000US12101,"Pasco County, Florida",199227,176748,803,158341,17604,22479
0500000US12055,"Highlands County, Florida",41026,33246,531,28660,4055,7780
0500000US12121,"Suwannee County, Florida",15083,12492,99,11265,1128,2591
0500000US12027,"DeSoto County, Florida",11996,7438,93,6293,1052,4558
0500000US12013,"Calhoun County, Florida",4556,3403,14,2850,539,1153
0500000US12023,"Columbia County, Florida",24985,22100,79,19149,2872,2885
0500000US12029,"Dixie County, Florida",6520,4770,90,3166,1514,1750
0500000US12107,"Putnam County, Florida",28264,22424,252,19077,3095,5840
0500000US12125,"Union County, Florida",3892,2878,91,2385,402,1014
0500000US12081,"Manatee County, Florida",143652,130369,373,115109,14887,13283
0500000US12075,"Levy County, Florida",16433,13470,160,10288,3022,2963
0500000US12003,"Baker County, Florida",8625,7502,58,6409,1035,1123
0500000US12127,"Volusia County, Florida",212985,191066,909,164644,25513,21919
0500000US12073,"Leon County, Florida",112918,106128,411,96729,8988,6790
0500000US12079,"Madison County, Florida",6682,4758,67,3886,805,1924
0500000US12033,"Escambia County, Florida",118740,106538,296,96253,9989,12202
0500000US12053,"Hernando County, Florida",73541,65863,448,59418,5997,7678
0500000US13037,"Calhoun County, Georgia",1853,1244,7,1047,190,609
0500000US13193,"Macon County, Georgia",4673,3476,5,2650,821,1197
0500000US13023,"Bleckley County, Georgia",4168,3155,16,2662,477,1013
0500000US13021,"Bibb County, Georgia",58010,48452,154,40903,7395,9558
0500000US13197,"Marion County, Georgia",3331,2548,10,1816,722,783
0500000US13249,"Schley County, Georgia",1877,1519,2,1286,231,358
0500000US13093,"Dooly County, Georgia",4861,3516,63,2795,658,1345
0500000US13119,"Franklin County, Georgia",8305,6501,76,5187,1238,1804
0500000US13103,"Effingham County, Georgia",20489,18865,263,16842,1760,1624
0500000US13171,"Lamar County, Georgia",6368,5242,0,4355,887,1126
0500000US13107,"Emanuel County, Georgia",8392,6716,16,5363,1337,1676
0500000US13239,"Quitman County, Georgia",934,633,5,443,185,301
0500000US13159,"Jasper County, Georgia",5087,4247,13,3425,809,840
0500000US13167,"Johnson County, Georgia",3361,2416,28,1885,503,945
0500000US13179,"Liberty County, Georgia",23232,21395,58,19261,2076,1837
0500000US13205,"Mitchell County, Georgia",7889,6034,39,5023,972,1855
0500000US13253,"Seminole County, Georgia",3325,2443,20,2102,321,882
0500000US13277,"Tift County, Georgia",15058,10889,95,9325,1469,4169
0500000US13289,"Twiggs County, Georgia",3031,1986,50,1611,325,1045
0500000US13233,"Polk County, Georgia",15011,12780,92,10750,1938,2231
0500000US13263,"Talbot County, Georgia",2766,1928,17,1461,450,838
0500000US13269,"Taylor County, Georgia",3437,2479,7,1893,579,958
0500000US13273,"Terrell County, Georgia",3247,2601,13,2268,320,646
0500000US13275,"Thomas County, Georgia",17352,14698,62,13255,1381,2654
0500000US13279,"Toombs County, Georgia",10403,7821,8,6761,1052,2582
0500000US13319,"Wilkinson County, Georgia",3237,2233,53,1726,454,1004
0500000US13017,"Ben Hill County, Georgia",6569,4761,30,3587,1144,1808
0500000US13033,"Burke County, Georgia",8184,6798,49,5425,1324,1386
0500000US13047,"Catoosa County, Georgia",24636,21685,175,19660,1850,2951
0500000US13053,"Chattahoochee County, Georgia",2550,2188,0,1986,202,362
0500000US13055,"Chattooga County, Georgia",9098,6929,20,5984,925,2169
0500000US13073,"Columbia County, Georgia",46840,43317,84,37585,5648,3523
0500000US13087,"Decatur County, Georgia",10153,6420,28,5304,1088,3733
0500000US13115,"Floyd County, Georgia",35633,29717,117,27191,2409,5916
0500000US13117,"Forsyth County, Georgia",73675,70702,100,68108,2494,2973
0500000US13137,"Habersham County, Georgia",15195,11692,81,9946,1665,3503
0500000US13185,"Lowndes County, Georgia",40472,34333,128,25737,8468,6139
0500000US13199,"Meriwether County, Georgia",8151,5930,133,4551,1246,2221
0500000US13207,"Monroe County, Georgia",9803,8368,63,7245,1060,1435
0500000US13261,"Sumter County, Georgia",11758,9725,96,7673,1956,2033
0500000US13265,"Taliaferro County, Georgia",612,388,2,255,131,224
0500000US13007,"Baker County, Georgia",1385,803,5,638,160,582
0500000US13035,"Butts County, Georgia",8157,6388,10,5404,974,1769
0500000US13043,"Candler County, Georgia",3965,2909,7,2258,644,1056
0500000US13045,"Carroll County, Georgia",41150,36350,141,32083,4126,4800
0500000US13079,"Crawford County, Georgia",4637,3853,55,3122,676,784
0500000US13081,"Crisp County, Georgia",8329,6325,50,4846,1429,2004
0500000US13077,"Coweta County, Georgia",51308,46771,110,42426,4235,4537
0500000US13067,"Cobb County, Georgia",277222,265254,772,247835,16647,11968
0500000US13083,"Dade County, Georgia",6070,5080,63,4389,628,990
0500000US13297,"Walton County, Georgia",31133,28137,148,24682,3307,2996
0500000US13027,"Brooks County, Georgia",6350,5101,70,4205,826,1249
0500000US13091,"Dodge County, Georgia",7694,5152,15,4191,946,2542
0500000US13105,"Elbert County, Georgia",7491,5049,38,4202,809,2442
0500000US13113,"Fayette County, Georgia",39753,37144,65,35332,1747,2609
0500000US13165,"Jenkins County, Georgia",3409,2547,45,1801,701,862
0500000US13217,"Newton County, Georgia",36626,33311,47,29938,3326,3315
0500000US13227,"Pickens County, Georgia",11841,10413,0,9695,718,1428
0500000US13071,"Colquitt County, Georgia",15374,12658,57,10587,2014,2716
0500000US13085,"Dawson County, Georgia",8711,8012,6,7182,824,699
0500000US13063,"Clayton County, Georgia",92845,84813,287,70735,13791,8032
0500000US13139,"Hall County, Georgia",63931,57195,147,52041,5007,6736
0500000US13149,"Heard County, Georgia",4489,3627,2,2954,671,862
0500000US13141,"Hancock County, Georgia",2991,1861,0,1358,503,1130
0500000US13189,"McDuffie County, Georgia",8103,5978,38,4629,1311,2125
0500000US13211,"Morgan County, Georgia",6656,5752,26,4877,849,904
0500000US13095,"Dougherty County, Georgia",34780,28586,61,24613,3912,6194
0500000US13111,"Fannin County, Georgia",10461,8827,82,7998,747,1634
0500000US13153,"Houston County, Georgia",56146,50041,61,44427,5553,6105
0500000US13175,"Laurens County, Georgia",17183,12337,148,9663,2526,4846
0500000US13255,"Spalding County, Georgia",24137,19460,54,15926,3480,4677
0500000US13271,"Telfair County, Georgia",4931,1971,0,1242,729,2960
0500000US13291,"Union County, Georgia",9070,7861,68,6600,1193,1209
0500000US13303,"Washington County, Georgia",7359,5629,24,4404,1201,1730
0500000US13311,"White County, Georgia",11588,9571,80,8231,1260,2017
0500000US13223,"Paulding County, Georgia",52389,48871,118,44252,4501,3518
0500000US13231,"Pike County, Georgia",6106,5284,38,4468,778,822
0500000US13245,"Richmond County, Georgia",72165,61070,238,51107,9725,11095
0500000US13267,"Tattnall County, Georgia",8237,6841,13,5674,1154,1396
0500000US13019,"Berrien County, Georgia",7322,5653,44,4338,1271,1669
0500000US13295,"Walker County, Georgia",25709,21403,116,18649,2638,4306
0500000US13135,"Gwinnett County, Georgia",288724,274793,633,251561,22599,13931
0500000US13013,"Barrow County, Georgia",25319,22635,142,20405,2088,2684
0500000US13049,"Charlton County, Georgia",3559,2698,47,2187,464,861
0500000US13065,"Clinch County, Georgia",2502,1663,19,1107,537,839
0500000US13015,"Bartow County, Georgia",37351,33631,193,29501,3937,3720
0500000US13097,"Douglas County, Georgia",48968,45650,41,38462,7147,3318
0500000US13131,"Grady County, Georgia",9037,7167,35,6303,829,1870
0500000US13161,"Jeff Davis County, Georgia",5270,4120,0,2864,1256,1150
0500000US13209,"Montgomery County, Georgia",3039,2442,13,2156,273,597
0500000US13221,"Oglethorpe County, Georgia",5621,4269,40,3620,609,1352
0500000US13243,"Randolph County, Georgia",2616,2013,37,1776,200,603
0500000US13247,"Rockdale County, Georgia",30521,28417,91,23958,4368,2104
0500000US13299,"Ware County, Georgia",13901,11683,15,9168,2500,2218
0500000US13305,"Wayne County, Georgia",10353,8486,16,6905,1565,1867
0500000US13309,"Wheeler County, Georgia",1937,741,21,626,94,1196
0500000US13315,"Wilcox County, Georgia",2606,1644,18,1310,316,962
0500000US13009,"Baldwin County, Georgia",16122,12978,82,11236,1660,3144
0500000US13031,"Bulloch County, Georgia",26955,23908,92,19582,4234,3047
0500000US13059,"Clarke County, Georgia",47224,42580,95,37526,4959,4644
0500000US13101,"Echols County, Georgia",1559,1058,0,689,369,501
0500000US13127,"Glynn County, Georgia",33777,29270,50,26037,3183,4507
0500000US13143,"Haralson County, Georgia",11128,9225,52,7978,1195,1903
0500000US13163,"Jefferson County, Georgia",5609,4157,48,2956,1153,1452
0500000US13169,"Jones County, Georgia",10510,9094,73,7950,1071,1416
0500000US13213,"Murray County, Georgia",14081,11777,93,10505,1179,2304
0500000US13215,"Muscogee County, Georgia",72924,62623,130,53919,8574,10301
0500000US13241,"Rabun County, Georgia",6563,5147,44,4503,600,1416
0500000US13259,"Stewart County, Georgia",1826,1267,4,1012,251,559
0500000US13283,"Treutlen County, Georgia",2641,1833,0,1519,314,808
0500000US13155,"Irwin County, Georgia",3291,2226,10,1829,387,1065
0500000US13003,"Atkinson County, Georgia",2785,2050,10,1514,526,735
0500000US13005,"Bacon County, Georgia",3966,3158,0,2432,726,808
0500000US13025,"Brantley County, Georgia",6564,5309,51,4026,1232,1255
0500000US16087,"Washington County, Idaho",4018,3338,59,2690,589,680
0500000US16031,"Cassia County, Idaho",7904,7238,11,6544,683,666
0500000US16045,"Gem County, Idaho",6583,5692,104,4925,663,891
0500000US16085,"Valley County, Idaho",3461,3245,33,2816,396,216
0500000US16003,"Adams County, Idaho",1675,1391,18,1132,241,284
0500000US16069,"Nez Perce County, Idaho",16302,14340,186,12571,1583,1962
0500000US16055,"Kootenai County, Idaho",60497,54831,249,49428,5154,5666
0500000US16061,"Lewis County, Idaho",1632,1267,20,1014,233,365
0500000US16023,"Butte County, Idaho",1050,887,25,751,111,163
0500000US16083,"Twin Falls County, Idaho",30697,27501,225,24565,2711,3196
0500000US16073,"Owyhee County, Idaho",4250,3340,111,2747,482,910
0500000US16015,"Boise County, Idaho",3110,2752,45,2322,385,358
0500000US16029,"Caribou County, Idaho",2618,2405,30,2183,192,213
0500000US16001,"Ada County, Idaho",168741,155374,906,136551,17917,13367
0500000US16005,"Bannock County, Idaho",30841,28248,177,25454,2617,2593
0500000US16011,"Bingham County, Idaho",14772,13218,155,11937,1126,1554
0500000US16025,"Camas County, Idaho",357,292,0,222,70,65
0500000US16027,"Canyon County, Idaho",70847,63532,584,54842,8106,7315
0500000US16051,"Jefferson County, Idaho",8647,8084,104,7228,752,563
0500000US16057,"Latah County, Idaho",15530,14555,120,12748,1687,975
0500000US16075,"Payette County, Idaho",8768,7504,87,6367,1050,1264
0500000US16009,"Benewah County, Idaho",3346,2755,25,2252,478,591
0500000US16033,"Clark County, Idaho",305,237,5,187,45,68
0500000US16039,"Elmore County, Idaho",10285,9110,55,8065,990,1175
0500000US16043,"Fremont County, Idaho",4309,3741,63,3303,375,568
0500000US16079,"Shoshone County, Idaho",5540,4728,16,3834,878,812
0500000US16049,"Idaho County, Idaho",6466,5221,123,4315,783,1245
0500000US15001,"Hawaii County, Hawaii",68412,58817,522,51002,7293,9595
0500000US15009,"Maui County, Hawaii",54274,48836,173,44642,4021,5438
0500000US15007,"Kauai County, Hawaii",22524,19975,305,18212,1458,2549
0500000US15005,"Kalawao County, Hawaii",47,36,0,28,8,11
0500000US17083,"Jersey County, Illinois",8665,7117,141,6034,942,1548
0500000US17155,"Putnam County, Illinois",2395,2053,5,1837,211,342
0500000US17039,"De Witt County, Illinois",6663,5770,22,5140,608,893
0500000US17051,"Fayette County, Illinois",7616,5660,37,5125,498,1956
0500000US17103,"Lee County, Illinois",13699,11693,33,10644,1016,2006
0500000US17107,"Logan County, Illinois",10872,9211,57,8199,955,1661
0500000US17117,"Macoupin County, Illinois",18772,16072,150,14526,1396,2700
0500000US17159,"Richland County, Illinois",6482,5344,65,4766,513,1138
0500000US17165,"Saline County, Illinois",10002,7906,116,6705,1085,2096
0500000US17189,"Washington County, Illinois",5975,4922,41,4404,477,1053
0500000US17135,"Montgomery County, Illinois",11339,9336,96,8182,1058,2003
0500000US17195,"Whiteside County, Illinois",23346,19963,135,18213,1615,3383
0500000US17001,"Adams County, Illinois",27300,22858,165,20515,2178,4442
0500000US17027,"Clinton County, Illinois",14190,11710,127,10540,1043,2480
0500000US17037,"DeKalb County, Illinois",37703,34985,115,32361,2509,2718
0500000US17047,"Edwards County, Illinois",2776,2338,28,2090,220,438
0500000US17079,"Jasper County, Illinois",3656,2908,17,2614,277,748
0500000US17081,"Jefferson County, Illinois",15223,12981,79,11604,1298,2242
0500000US17197,"Will County, Illinois",227848,212204,880,198739,12585,15644
0500000US17199,"Williamson County, Illinois",27089,22044,187,19891,1966,5045
0500000US17041,"Douglas County, Illinois",7618,6089,29,5476,584,1529
0500000US17057,"Fulton County, Illinois",14090,11704,124,10433,1147,2386
0500000US17061,"Greene County, Illinois",5005,3932,73,3403,456,1073
0500000US17069,"Hardin County, Illinois",1438,1127,1,983,143,311
0500000US17073,"Henry County, Illinois",20023,16680,195,14760,1725,3343
0500000US17095,"Knox County, Illinois",20830,16770,141,14832,1797,4060
0500000US17097,"Lake County, Illinois",244672,228065,843,215530,11692,16607
0500000US17127,"Massac County, Illinois",6011,4135,60,3749,326,1876
0500000US17171,"Scott County, Illinois",1959,1675,19,1516,140,284
0500000US17017,"Cass County, Illinois",5024,4261,26,3649,586,763
0500000US17099,"LaSalle County, Illinois",44644,38488,263,35466,2759,6156
0500000US17067,"Hancock County, Illinois",7420,5850,75,5192,583,1570
0500000US17063,"Grundy County, Illinois",19398,17638,107,15902,1629,1760
0500000US17091,"Kankakee County, Illinois",40050,34501,112,30355,4034,5549
0500000US17043,"DuPage County, Illinois",341823,317693,1034,301087,15572,24130
0500000US17167,"Sangamon County, Illinois",83661,73700,382,65589,7729,9961
0500000US17129,"Menard County, Illinois",5198,4567,25,4171,371,631
0500000US17177,"Stephenson County, Illinois",19609,16513,137,14961,1415,3096
0500000US17031,"Cook County, Illinois",1963070,1719551,7486,1534793,177272,243519
0500000US17141,"Ogle County, Illinois",20901,18408,146,16407,1855,2493
0500000US17137,"Morgan County, Illinois",13864,11638,121,10303,1214,2226
0500000US17193,"White County, Illinois",6082,4987,55,4370,562,1095
0500000US17203,"Woodford County, Illinois",14566,12907,97,11759,1051,1659
0500000US17071,"Henderson County, Illinois",2990,2561,5,2294,262,429
0500000US17111,"McHenry County, Illinois",111812,105350,518,100988,3844,6462
0500000US17113,"McLean County, Illinois",66159,61158,475,53581,7102,5001
0500000US17145,"Perry County, Illinois",8323,6799,64,6011,724,1524
0500000US17149,"Pike County, Illinois",6527,5248,65,4454,729,1279
0500000US17161,"Rock Island County, Illinois",60294,51883,281,46903,4699,8411
0500000US17163,"St. Clair County, Illinois",103063,86655,724,74090,11841,16408
0500000US17185,"Wabash County, Illinois",4896,4232,73,3717,442,664
0500000US17013,"Calhoun County, Illinois",1805,1368,10,1198,160,437
0500000US17035,"Cumberland County, Illinois",4322,3558,24,3144,390,764
0500000US17085,"Jo Daviess County, Illinois",9758,8440,76,7499,865,1318
0500000US17089,"Kane County, Illinois",178050,164877,563,153879,10435,13173
0500000US17101,"Lawrence County, Illinois",6144,5149,25,4332,792,995
0500000US17009,"Brown County, Illinois",2087,1641,22,1457,162,446
0500000US17123,"Marshall County, Illinois",4893,4030,40,3580,410,863
0500000US17075,"Iroquois County, Illinois",11779,9894,70,9050,774,1885
0500000US17021,"Christian County, Illinois",13939,11794,165,10505,1124,2145
0500000US17025,"Clay County, Illinois",5638,4778,23,4190,565,860
0500000US17059,"Gallatin County, Illinois",2314,1830,16,1545,269,484
0500000US17077,"Jackson County, Illinois",23728,20728,119,17809,2800,3000
0500000US17133,"Monroe County, Illinois",13349,11916,76,10907,933,1433
0500000US17143,"Peoria County, Illinois",73629,63498,395,55224,7879,10131
0500000US17181,"Union County, Illinois",6669,4888,63,4189,636,1781
0500000US17201,"Winnebago County, Illinois",114608,100408,558,90543,9307,14200
0500000US17147,"Piatt County, Illinois",6700,5957,18,5538,401,743
0500000US17153,"Pulaski County, Illinois",2173,1266,11,1108,147,907
0500000US17169,"Schuyler County, Illinois",2836,2369,0,2172,197,467
0500000US17175,"Stark County, Illinois",2294,1870,17,1631,222,424
0500000US17045,"Edgar County, Illinois",7590,6229,24,5502,703,1361
0500000US17005,"Bond County, Illinois",6218,5169,45,4622,502,1049
0500000US17007,"Boone County, Illinois",18731,17035,98,15721,1216,1696
0500000US17011,"Bureau County, Illinois",13805,11798,62,10484,1252,2007
0500000US17015,"Carroll County, Illinois",6476,5504,27,4966,511,972
0500000US17029,"Coles County, Illinois",21139,18400,44,16122,2234,2739
0500000US17033,"Crawford County, Illinois",7653,6481,127,5575,779,1172
0500000US18105,"Monroe County, Indiana",55537,51593,149,45703,5741,3944
0500000US18045,"Fountain County, Indiana",7015,5905,31,5197,677,1110
0500000US18039,"Elkhart County, Indiana",72329,61408,701,55145,5562,10921
0500000US18025,"Crawford County, Indiana",3915,3028,59,2386,583,887
0500000US18017,"Cass County, Indiana",14666,12550,56,10661,1833,2116
0500000US18097,"Marion County, Indiana",369033,315358,999,279131,35228,53675
0500000US18021,"Clay County, Indiana",10510,8800,50,7693,1057,1710
0500000US18063,"Hendricks County, Indiana",58078,54859,253,50409,4197,3219
0500000US18047,"Franklin County, Indiana",8744,7193,129,6043,1021,1551
0500000US18053,"Grant County, Indiana",26121,21946,240,17820,3886,4175
0500000US18071,"Jackson County, Indiana",16746,13720,103,12080,1537,3026
0500000US18067,"Howard County, Indiana",34550,29910,203,26118,3589,4640
0500000US18119,"Owen County, Indiana",8695,6822,66,5776,980,1873
0500000US18135,"Randolph County, Indiana",10477,8885,128,7466,1291,1592
0500000US18183,"Whitley County, Indiana",13548,12199,160,10542,1497,1349
0500000US18013,"Brown County, Indiana",6093,5412,94,4391,927,681
0500000US18023,"Clinton County, Indiana",12007,10498,79,8918,1501,1509
0500000US18161,"Union County, Indiana",2846,2384,13,1886,485,462
0500000US18093,"Lawrence County, Indiana",18487,15160,127,13114,1919,3327
0500000US18027,"Daviess County, Indiana",11417,8648,91,7392,1165,2769
0500000US18029,"Dearborn County, Indiana",18648,16557,328,14791,1438,2091
0500000US18083,"Knox County, Indiana",14955,13068,107,11368,1593,1887
0500000US18123,"Perry County, Indiana",7465,5915,79,5156,680,1550
0500000US18131,"Pulaski County, Indiana",5200,4399,75,3738,586,801
0500000US18129,"Posey County, Indiana",10175,8991,66,7667,1258,1184
0500000US18171,"Warren County, Indiana",3384,2986,36,2551,399,398
0500000US18165,"Vermillion County, Indiana",6616,5654,18,5029,607,962
0500000US18003,"Allen County, Indiana",143500,128181,553,114854,12774,15319
0500000US18031,"Decatur County, Indiana",10425,9012,54,7430,1528,1413
0500000US18043,"Floyd County, Indiana",29356,25716,140,22375,3201,3640
0500000US18079,"Jennings County, Indiana",10659,8890,85,7609,1196,1769
0500000US18081,"Johnson County, Indiana",55777,51422,278,46632,4512,4355
0500000US18109,"Morgan County, Indiana",25926,23020,238,20188,2594,2906
0500000US18051,"Gibson County, Indiana",13244,11377,73,10018,1286,1867
0500000US18117,"Orange County, Indiana",7881,6074,96,5015,963,1807
0500000US18085,"Kosciusko County, Indiana",30676,27122,204,23527,3391,3554
0500000US18099,"Marshall County, Indiana",17245,14207,264,11954,1989,3038
0500000US18163,"Vanderburgh County, Indiana",75197,65485,203,58021,7261,9712
0500000US18009,"Blackford County, Indiana",5225,4298,36,3542,720,927
0500000US18143,"Scott County, Indiana",9004,7293,104,5936,1253,1711
0500000US18061,"Harrison County, Indiana",14584,12579,217,10236,2126,2005
0500000US18091,"LaPorte County, Indiana",42904,37821,288,32816,4717,5083
0500000US18169,"Wabash County, Indiana",12875,11268,148,9220,1900,1607
0500000US18073,"Jasper County, Indiana",12539,10938,109,9889,940,1601
0500000US18101,"Martin County, Indiana",4198,3375,75,2953,347,823
0500000US18127,"Porter County, Indiana",63969,58294,530,52630,5134,5675
0500000US18145,"Shelby County, Indiana",17725,15223,127,12882,2214,2502
0500000US18137,"Ripley County, Indiana",11165,9552,99,8226,1227,1613
0500000US18147,"Spencer County, Indiana",8109,6636,97,5622,917,1473
0500000US18153,"Sullivan County, Indiana",7707,6201,50,5010,1141,1506
0500000US18159,"Tipton County, Indiana",6295,5516,55,4611,850,779
0500000US18157,"Tippecanoe County, Indiana",69112,64549,219,56579,7751,4563
0500000US18167,"Vigo County, Indiana",41874,36255,270,31687,4298,5619
0500000US18173,"Warrick County, Indiana",24267,22023,147,20023,1853,2244
0500000US18057,"Hamilton County, Indiana",116982,113099,507,108584,4008,3883
0500000US18033,"DeKalb County, Indiana",16789,14657,166,12920,1571,2132
0500000US18087,"LaGrange County, Indiana",12079,7995,109,7004,882,4084
0500000US18005,"Bartholomew County, Indiana",31669,27350,175,24133,3042,4319
0500000US18139,"Rush County, Indiana",6725,5578,23,4184,1371,1147
0500000US18011,"Boone County, Indiana",24645,22715,136,21056,1523,1930
0500000US18049,"Fulton County, Indiana",7884,6723,89,5626,1008,1161
0500000US18089,"Lake County, Indiana",185437,159132,911,141693,16528,26305
0500000US18107,"Montgomery County, Indiana",15271,13473,87,11868,1518,1798
0500000US18113,"Noble County, Indiana",18090,15674,212,14027,1435,2416
0500000US18001,"Adams County, Indiana",12476,9527,231,8306,990,2949
0500000US18041,"Fayette County, Indiana",9568,7818,37,6295,1486,1750
0500000US19055,"Delaware County, Iowa",6939,5926,149,5190,587,1013
0500000US19185,"Wayne County, Iowa",2669,2042,14,1815,213,627
0500000US19113,"Linn County, Iowa",89807,80999,589,73630,6780,8808
0500000US19163,"Scott County, Iowa",67025,57415,419,52431,4565,9610
0500000US19141,"O'Brien County, Iowa",6031,5146,55,4515,576,885
0500000US19011,"Benton County, Iowa",10224,8930,143,7782,1005,1294
0500000US19061,"Dubuque County, Iowa",38330,33911,266,30770,2875,4419
0500000US19079,"Hamilton County, Iowa",6315,5309,59,4628,622,1006
0500000US19151,"Pocahontas County, Iowa",3205,2710,52,2406,252,495
0500000US19175,"Union County, Iowa",5194,4332,52,3794,486,862
0500000US19177,"Van Buren County, Iowa",2863,2223,50,1783,390,640
0500000US19159,"Ringgold County, Iowa",1997,1617,16,1421,180,380
0500000US19051,"Davis County, Iowa",3215,2308,18,2005,285,907
0500000US19001,"Adair County, Iowa",3136,2673,43,2246,384,463
0500000US19009,"Audubon County, Iowa",2677,2201,14,1887,300,476
0500000US19039,"Clarke County, Iowa",3854,3360,15,2930,415,494
0500000US19093,"Ida County, Iowa",3010,2481,44,2207,230,529
0500000US19107,"Keokuk County, Iowa",4384,3579,44,3180,355,805
0500000US19135,"Monroe County, Iowa",3329,2861,38,2358,465,468
0500000US19179,"Wapello County, Iowa",14418,12048,115,10458,1475,2370
0500000US19167,"Sioux County, Iowa",12166,10935,82,10383,470,1231
0500000US19025,"Calhoun County, Iowa",4191,3571,29,3169,373,620
0500000US19031,"Cedar County, Iowa",7546,6519,157,5868,494,1027
0500000US19033,"Cerro Gordo County, Iowa",19213,16368,65,14560,1743,2845
0500000US19073,"Greene County, Iowa",3889,3376,37,2865,474,513
0500000US19083,"Hardin County, Iowa",7175,5865,94,5099,672,1310
0500000US19117,"Lucas County, Iowa",3642,3090,20,2689,381,552
0500000US19189,"Winnebago County, Iowa",4605,3916,47,3482,387,689
0500000US19147,"Palo Alto County, Iowa",3812,3306,7,2850,449,506
0500000US19007,"Appanoose County, Iowa",5416,4449,48,3655,746,967
0500000US19095,"Iowa County, Iowa",6791,5935,140,4991,804,856
0500000US19099,"Jasper County, Iowa",14548,12528,164,11041,1323,2020
0500000US19191,"Winneshiek County, Iowa",8205,7109,61,6432,616,1096
0500000US19157,"Poweshiek County, Iowa",7681,6661,143,5830,688,1020
0500000US19127,"Marshall County, Iowa",15338,13130,186,11123,1821,2208
0500000US19015,"Boone County, Iowa",10940,9826,90,8533,1203,1114
0500000US19017,"Bremer County, Iowa",9585,8379,86,7607,686,1206
0500000US19089,"Howard County, Iowa",3868,3188,49,2797,342,680
0500000US19063,"Emmet County, Iowa",4110,3440,28,2987,425,670
0500000US19081,"Hancock County, Iowa",4766,3988,30,3530,428,778
0500000US19121,"Madison County, Iowa",6309,5558,54,4996,508,751
0500000US19125,"Marion County, Iowa",13314,11433,126,10060,1247,1881
0500000US19197,"Wright County, Iowa",5690,4499,95,3832,572,1191
0500000US39097,"Madison County, Ohio",15080,13270,41,12152,1077,1810
0500000US39119,"Muskingum County, Ohio",34239,28963,266,25542,3155,5276
0500000US27037,"Dakota County, Minnesota",160144,150645,482,140982,9181,9499
0500000US27083,"Lyon County, Minnesota",10050,8999,76,8192,731,1051
0500000US27129,"Renville County, Minnesota",6180,5153,48,4047,1058,1027
0500000US27031,"Cook County, Minnesota",2699,2414,66,2083,265,285
0500000US27093,"Meeker County, Minnesota",9191,7844,90,6808,946,1347
0500000US27113,"Pennington County, Minnesota",5970,5137,9,4546,582,833
0500000US27167,"Wilkin County, Minnesota",2826,2373,17,2098,258,453
0500000US27027,"Clay County, Minnesota",23782,20877,98,18568,2211,2905
0500000US27045,"Fillmore County, Minnesota",8595,7188,123,6335,730,1407
0500000US27119,"Polk County, Minnesota",12516,10547,62,9671,814,1969
0500000US27135,"Roseau County, Minnesota",5995,5127,77,3499,1551,868
0500000US27165,"Watonwan County, Minnesota",4318,3485,33,2882,570,833
0500000US27011,"Big Stone County, Minnesota",2274,1787,11,1632,144,487
0500000US27021,"Cass County, Minnesota",13007,11132,168,9793,1171,1875
0500000US27049,"Goodhue County, Minnesota",19313,17164,206,15530,1428,2149
0500000US27063,"Jackson County, Minnesota",4388,3754,43,3323,388,634
0500000US27105,"Nobles County, Minnesota",7897,6695,95,5736,864,1202
0500000US27141,"Sherburne County, Minnesota",31737,29714,322,27366,2026,2023
0500000US27019,"Carver County, Minnesota",35852,33737,199,31885,1653,2115
0500000US27061,"Itasca County, Minnesota",19346,16454,153,14568,1733,2892
0500000US27123,"Ramsey County, Minnesota",209069,190205,1054,175344,13807,18864
0500000US27169,"Winona County, Minnesota",19515,17316,126,15766,1424,2199
0500000US28089,"Madison County, Mississippi",39020,35595,105,31770,3720,3425
0500000US28091,"Marion County, Mississippi",9543,7001,111,4665,2225,2542
0500000US48449,"Titus County, Texas",10694,8540,109,7005,1426,2154
0500000US48291,"Liberty County, Texas",26203,21862,132,19605,2125,4341
0500000US48497,"Wise County, Texas",22080,19923,162,16562,3199,2157
0500000US48249,"Jim Wells County, Texas",13043,8504,186,7099,1219,4539
0500000US48127,"Dimmit County, Texas",3309,2107,0,1829,278,1202
0500000US48157,"Fort Bend County, Texas",230381,222043,777,210598,10668,8338
0500000US48235,"Irion County, Texas",634,545,8,436,101,89
0500000US48097,"Cooke County, Texas",15368,13260,20,11606,1634,2108
0500000US48115,"Dawson County, Texas",4322,3536,33,2896,607,786
0500000US48051,"Burleson County, Texas",6754,5255,61,4546,648,1499
0500000US48245,"Jefferson County, Texas",94002,76097,247,63573,12277,17905
0500000US48359,"Oldham County, Texas",527,451,3,399,49,76
0500000US48141,"El Paso County, Texas",265724,225293,645,195754,28894,40431
0500000US48443,"Terrell County, Texas",396,241,0,185,56,155
0500000US48463,"Uvalde County, Texas",8683,6485,69,5493,923,2198
0500000US48009,"Archer County, Texas",3332,2912,13,2467,432,420
0500000US48215,"Hidalgo County, Texas",234879,196133,744,151122,44267,38746
0500000US48425,"Somervell County, Texas",3239,2876,5,2330,541,363
0500000US49045,"Tooele County, Utah",19901,18522,77,17452,993,1379
0500000US48207,"Haskell County, Texas",2125,1543,8,1262,273,582
0500000US48333,"Mills County, Texas",1750,1420,22,1218,180,330
0500000US48351,"Newton County, Texas",4978,3926,47,3062,817,1052
0500000US49043,"Summit County, Utah",14555,13977,24,13361,592,578
0500000US49031,"Piute County, Utah",499,418,13,335,70,81
0500000US49001,"Beaver County, Utah",2277,1994,20,1688,286,283
0500000US49039,"Sanpete County, Utah",8483,7728,95,6761,872,755
0500000US49049,"Utah County, Utah",160649,156094,502,138331,17261,4555
0500000US50011,"Franklin County, Vermont",18582,16096,120,14745,1231,2486
0500000US50003,"Bennington County, Vermont",14927,13190,182,11677,1331,1737
0500000US50009,"Essex County, Vermont",2756,2148,53,1879,216,608
0500000US51530,"Buena Vista city, Virginia",2539,1845,31,1569,245,694
0500000US51730,"Petersburg city, Virginia",13274,10420,74,8432,1914,2854
0500000US51600,"Fairfax city, Virginia",8553,8348,39,8027,282,205
0500000US51683,"Manassas city, Virginia",12749,11740,77,10999,664,1009
0500000US51800,"Suffolk city, Virginia",33198,29877,109,25863,3905,3321
0500000US51041,"Chesterfield County, Virginia",123010,115338,323,109082,5933,7672
0500000US51093,"Isle of Wight County, Virginia",14304,12533,113,10672,1748,1771
0500000US51620,"Franklin city, Virginia",3526,2781,4,2311,466,745
0500000US51540,"Charlottesville city, Virginia",18613,17030,68,14962,2000,1583
0500000US51087,"Henrico County, Virginia",127111,116257,362,107506,8389,10854
0500000US51101,"King William County, Virginia",6170,5299,73,4332,894,871
0500000US51109,"Louisa County, Virginia",13575,11719,170,10061,1488,1856
0500000US51147,"Prince Edward County, Virginia",7187,5592,61,4688,843,1595
0500000US51159,"Richmond County, Virginia",3139,2491,10,2122,359,648
0500000US51177,"Spotsylvania County, Virginia",43677,41100,157,38266,2677,2577
0500000US51043,"Clarke County, Virginia",5639,4947,7,4164,776,692
0500000US51117,"Mecklenburg County, Virginia",11815,8204,208,6571,1425,3611
0500000US51015,"Augusta County, Virginia",29297,24678,171,21007,3500,4619
0500000US51051,"Dickenson County, Virginia",5841,4213,42,3446,725,1628
0500000US51107,"Loudoun County, Virginia",125309,121512,236,116874,4402,3797
0500000US51161,"Roanoke County, Virginia",38343,34411,114,31127,3170,3932
0500000US51570,"Colonial Heights city, Virginia",7054,6100,93,5387,620,954
0500000US51021,"Bland County, Virginia",2523,2052,30,1721,301,471
0500000US51029,"Buckingham County, Virginia",5827,4529,79,3469,981,1298
0500000US51580,"Covington city, Virginia",2409,1830,34,1587,209,579
0500000US51810,"Virginia Beach city, Virginia",169290,159892,303,147817,11772,9398
0500000US51640,"Galax city, Virginia",2742,2112,7,1805,300,630
0500000US51193,"Westmoreland County, Virginia",7612,6461,26,5621,814,1151
0500000US51155,"Pulaski County, Virginia",14525,11727,170,9603,1954,2798
0500000US51590,"Danville city, Virginia",18479,14238,77,12333,1828,4241
0500000US51009,"Amherst County, Virginia",12044,9429,91,7734,1604,2615
0500000US51017,"Bath County, Virginia",1999,1583,50,1258,275,416
0500000US51700,"Newport News city, Virginia",69324,62255,234,51215,10806,7069
0500000US51680,"Lynchburg city, Virginia",28069,23962,86,20781,3095,4107
0500000US51690,"Martinsville city, Virginia",5630,4669,10,3951,708,961
0500000US51057,"Essex County, Virginia",4463,3464,61,2540,863,999
0500000US51790,"Staunton city, Virginia",10520,8965,19,7724,1222,1555
0500000US51750,"Radford city, Virginia",5438,4690,71,4189,430,748
0500000US51045,"Craig County, Virginia",2266,1822,77,1535,210,444
0500000US51071,"Giles County, Virginia",6987,5483,52,5006,425,1504
0500000US51157,"Rappahannock County, Virginia",2976,2540,29,2194,317,436
0500000US54085,"Ritchie County, West Virginia",3930,3007,33,2582,392,923
0500000US54043,"Lincoln County, West Virginia",7879,6027,31,5492,504,1852
0500000US54079,"Putnam County, West Virginia",21665,18850,168,16003,2679,2815
0500000US54005,"Boone County, West Virginia",9148,7288,16,6613,659,1860
0500000US54051,"Marshall County, West Virginia",12232,9647,23,8529,1095,2585
0500000US54093,"Tucker County, West Virginia",3103,2482,11,2248,223,621
0500000US54073,"Pleasants County, West Virginia",2869,2410,53,2051,306,459
0500000US54087,"Roane County, West Virginia",5679,4301,53,3628,620,1378
0500000US54107,"Wood County, West Virginia",36018,30607,131,27744,2732,5411
0500000US54053,"Mason County, West Virginia",10849,8097,23,7069,1005,2752
0500000US54037,"Jefferson County, West Virginia",20895,19096,48,17174,1874,1799
0500000US54045,"Logan County, West Virginia",13875,11109,3,10344,762,2766
0500000US53031,"Jefferson County, Washington",14239,12990,99,12407,484,1249
0500000US53049,"Pacific County, Washington",9087,7810,100,7020,690,1277
0500000US53059,"Skamania County, Washington",4685,3911,46,3526,339,774
0500000US53009,"Clallam County, Washington",32732,28941,241,27049,1651,3791
0500000US53039,"Klickitat County, Washington",8539,7330,102,6572,656,1209
0500000US53017,"Douglas County, Washington",15064,13686,60,11746,1880,1378
0500000US53053,"Pierce County, Washington",317699,293782,1400,270000,22382,23917
0500000US53071,"Walla Walla County, Washington",22304,20363,54,18496,1813,1941
0500000US53061,"Snohomish County, Washington",289737,273971,1031,257275,15665,15766
0500000US53067,"Thurston County, Washington",108070,99908,466,93034,6408,8162
0500000US53011,"Clark County, Washington",171522,161729,776,151397,9556,9793
0500000US53001,"Adams County, Washington",5881,4615,23,3835,757,1266
0500000US53057,"Skagit County, Washington",47937,43723,217,41086,2420,4214
0500000US53043,"Lincoln County, Washington",4485,4045,102,3516,427,440
0500000US55119,"Taylor County, Wisconsin",8632,6930,137,6205,588,1702
0500000US55099,"Price County, Wisconsin",6605,5424,121,4751,552,1181
0500000US55079,"Milwaukee County, Wisconsin",382070,325397,1609,288507,35281,56673
0500000US55033,"Dunn County, Wisconsin",16818,14894,188,13377,1329,1924
0500000US55045,"Green County, Wisconsin",15098,12894,222,11358,1314,2204
0500000US55115,"Shawano County, Wisconsin",17019,13906,176,12681,1049,3113
0500000US55078,"Menominee County, Wisconsin",1443,1035,6,964,65,408
0500000US55011,"Buffalo County, Wisconsin",5713,4807,88,4411,308,906
0500000US55063,"La Crosse County, Wisconsin",47319,42380,277,38876,3227,4939
0500000US55035,"Eau Claire County, Wisconsin",40753,36506,149,33619,2738,4247
0500000US55095,"Polk County, Wisconsin",18314,15726,248,13598,1880,2588
0500000US55133,"Waukesha County, Wisconsin",157548,146080,666,139247,6167,11468
0500000US55125,"Vilas County, Wisconsin",10914,9151,116,7863,1172,1763
0500000US55057,"Juneau County, Wisconsin",10640,8899,141,7734,1024,1741
0500000US55131,"Washington County, Wisconsin",54138,48945,302,45632,3011,5193
0500000US55025,"Dane County, Wisconsin",219490,206690,1267,189903,15520,12800
0500000US55039,"Fond du Lac County, Wisconsin",41346,35992,383,32656,2953,5354
0500000US55091,"Pepin County, Wisconsin",3095,2581,27,2405,149,514
0500000US55097,"Portage County, Wisconsin",28357,25307,119,23584,1604,3050
0500000US56023,"Lincoln County, Wyoming",7075,6630,42,5619,969,445
0500000US56021,"Laramie County, Wyoming",39179,35973,154,32616,3203,3206
0500000US72075,"Juana Díaz Municipio, Puerto Rico",15673,11589,5,10622,962,4084
0500000US72133,"Santa Isabel Municipio, Puerto Rico",7465,3897,0,3441,456,3568
0500000US72057,"Guayama Municipio, Puerto Rico",14476,7232,0,5964,1268,7244
0500000US72063,"Gurabo Municipio, Puerto Rico",14780,10902,67,9910,925,3878
0500000US72087,"Loíza Municipio, Puerto Rico",8728,6000,24,5569,407,2728
0500000US72005,"Aguadilla Municipio, Puerto Rico",21604,14863,47,13058,1758,6741
0500000US72083,"Las Marías Municipio, Puerto Rico",2872,1056,30,830,196,1816
0500000US72149,"Villalba Municipio, Puerto Rico",7712,5550,11,4949,590,2162
0500000US72031,"Carolina Municipio, Puerto Rico",63401,50257,150,44997,5110,13144
0500000US72047,"Corozal Municipio, Puerto Rico",10768,6543,41,4852,1650,4225
0500000US72113,"Ponce Municipio, Puerto Rico",52696,32252,155,25785,6312,20444
0500000US72137,"Toa Baja Municipio, Puerto Rico",27258,20148,145,13836,6167,7110
0500000US72003,"Aguada Municipio, Puerto Rico",12819,7449,730,5832,887,5370
0500000US72039,"Ciales Municipio, Puerto Rico",5870,3357,0,2471,886,2513
0500000US72041,"Cidra Municipio, Puerto Rico",12913,7216,212,5537,1467,5697
0500000US72089,"Luquillo Municipio, Puerto Rico",6519,4672,48,4154,470,1847
0500000US72129,"San Lorenzo Municipio, Puerto Rico",13749,6939,224,5268,1447,6810
0500000US72073,"Jayuya Municipio, Puerto Rico",5087,3271,11,2417,843,1816
0500000US72119,"Río Grande Municipio, Puerto Rico",15732,10980,32,9764,1184,4752
0500000US72145,"Vega Baja Municipio, Puerto Rico",18081,11674,47,7490,4137,6407
0500000US72059,"Guayanilla Municipio, Puerto Rico",6485,4245,17,3766,462,2240
0500000US72079,"Lajas Municipio, Puerto Rico",7911,1815,9,1511,295,6096
0500000US01093,"Marion County, Alabama",12212,9472,67,7738,1667,2740
0500000US01073,"Jefferson County, Alabama",260924,224867,688,197204,26975,36057
0500000US01059,"Franklin County, Alabama",11210,8026,43,6598,1385,3184
0500000US01019,"Cherokee County, Alabama",10606,8495,30,7216,1249,2111
0500000US01047,"Dallas County, Alabama",16336,11723,115,10105,1503,4613
0500000US01087,"Macon County, Alabama",7637,5615,39,4160,1416,2022
0500000US01117,"Shelby County, Alabama",78328,73069,207,67283,5579,5259
0500000US01003,"Baldwin County, Alabama",78622,69635,412,61121,8102,8987
0500000US01069,"Houston County, Alabama",39253,31438,419,27364,3655,7815
0500000US01125,"Tuscaloosa County, Alabama",72379,62598,150,55848,6600,9781
0500000US01027,"Clay County, Alabama",5236,4130,16,3543,571,1106
0500000US01109,"Pike County, Alabama",11547,8006,199,6801,1006,3541
0500000US01037,"Coosa County, Alabama",4103,3085,21,2586,478,1018
0500000US01065,"Hale County, Alabama",5658,3713,20,3020,673,1945
0500000US01053,"Escambia County, Alabama",13428,8778,99,7578,1101,4650
0500000US01013,"Butler County, Alabama",6708,4703,57,4051,595,2005
0500000US01105,"Perry County, Alabama",3079,1722,25,1407,290,1357
0500000US01035,"Conecuh County, Alabama",4574,2634,28,2153,453,1940
0500000US01007,"Bibb County, Alabama",6840,5217,5,4455,757,1623
0500000US01017,"Chambers County, Alabama",13516,10240,76,8825,1339,3276
0500000US01057,"Fayette County, Alabama",6947,5408,27,4745,636,1539
0500000US01009,"Blount County, Alabama",20600,16202,185,13951,2066,4398
0500000US01001,"Autauga County, Alabama",21115,18368,48,16549,1771,2747
0500000US01061,"Geneva County, Alabama",10479,8362,93,6911,1358,2117
0500000US02261,"Valdez-Cordova Census Area, Alaska",3093,2824,4,2416,404,269
0500000US02105,"Hoonah-Angoon Census Area, Alaska",799,672,0,558,114,127
0500000US02275,"Wrangell City and Borough, Alaska",1074,888,4,770,114,186
0500000US04019,"Pima County, Arizona",400907,364714,1803,331375,31536,36193
0500000US04007,"Gila County, Arizona",21708,17469,133,13093,4243,4239
0500000US04003,"Cochise County, Arizona",49250,42728,204,38301,4223,6522
0500000US04001,"Apache County, Arizona",20395,11220,184,7547,3489,9175
0500000US04025,"Yavapai County, Arizona",96007,86137,565,76499,9073,9870
0500000US04017,"Navajo County, Arizona",34407,25746,136,20499,5111,8661
0500000US05119,"Pulaski County, Arkansas",157083,135551,662,116872,18017,21532
0500000US05021,"Clay County, Arkansas",6441,4949,22,4043,884,1492
0500000US05039,"Dallas County, Arkansas",3033,2324,18,1723,583,709
0500000US05121,"Randolph County, Arkansas",7455,5759,70,4649,1040,1696
0500000US05009,"Boone County, Arkansas",14870,12611,125,11402,1084,2259
0500000US05063,"Independence County, Arkansas",14268,11759,133,8720,2906,2509
0500000US05053,"Grant County, Arkansas",6780,5942,44,4914,984,838
0500000US05045,"Faulkner County, Arkansas",44095,39257,230,33521,5506,4838
0500000US05089,"Marion County, Arkansas",6669,5590,22,4883,685,1079
0500000US05129,"Searcy County, Arkansas",3271,2457,48,1878,531,814
0500000US05033,"Crawford County, Arkansas",23701,19701,250,16481,2970,4000
0500000US05059,"Hot Spring County, Arkansas",12377,9979,116,7909,1954,2398
0500000US05087,"Madison County, Arkansas",6195,4790,55,3740,995,1405
0500000US05061,"Howard County, Arkansas",5096,3990,29,3174,787,1106
0500000US05093,"Mississippi County, Arkansas",16888,13711,59,10974,2678,3177
0500000US05139,"Union County, Arkansas",15904,11405,32,9432,1941,4499
0500000US39055,"Geauga County, Ohio",35285,30635,152,28350,2133,4650
0500000US39111,"Monroe County, Ohio",5945,4416,61,3698,657,1529
0500000US39085,"Lake County, Ohio",95980,86097,316,80303,5478,9883
0500000US39023,"Clark County, Ohio",54905,47571,168,43204,4199,7334
0500000US39075,"Holmes County, Ohio",12437,8017,95,6604,1318,4420
0500000US39165,"Warren County, Ohio",81859,76859,148,73408,3303,5000
0500000US39005,"Ashland County, Ohio",20439,17178,85,15678,1415,3261
0500000US40133,"Seminole County, Oklahoma",9222,7280,92,5517,1671,1942
0500000US40011,"Blaine County, Oklahoma",3908,3198,50,2490,658,710
0500000US40029,"Coal County, Oklahoma",2236,1666,25,1402,239,570
0500000US40073,"Kingfisher County, Oklahoma",5694,4861,74,3926,861,833
0500000US40095,"Marshall County, Oklahoma",6240,5270,31,3670,1569,970
0500000US40105,"Nowata County, Oklahoma",4084,3361,30,2501,830,723
0500000US40131,"Rogers County, Oklahoma",34452,31423,149,26770,4504,3029
0500000US40003,"Alfalfa County, Oklahoma",1958,1672,16,1456,200,286
0500000US40027,"Cleveland County, Oklahoma",105190,98027,350,89982,7695,7163
0500000US40005,"Atoka County, Oklahoma",5302,4181,33,3491,657,1121
0500000US40043,"Dewey County, Oklahoma",1701,1463,6,1245,212,238
0500000US40083,"Logan County, Oklahoma",15665,13486,78,12010,1398,2179
0500000US40147,"Washington County, Oklahoma",20667,17764,78,15480,2206,2903
0500000US40061,"Haskell County, Oklahoma",4864,3743,20,3019,704,1121
0500000US40111,"Okmulgee County, Oklahoma",14665,11834,95,9465,2274,2831
0500000US40067,"Jefferson County, Oklahoma",2367,1856,20,1400,436,511
0500000US40049,"Garvin County, Oklahoma",10425,8592,62,7338,1192,1833
0500000US40123,"Pontotoc County, Oklahoma",14354,11776,184,9301,2291,2578
0500000US40063,"Hughes County, Oklahoma",4073,2693,173,2015,505,1380
0500000US40031,"Comanche County, Oklahoma",42610,38032,124,34069,3839,4578
0500000US40117,"Pawnee County, Oklahoma",6205,4984,28,3677,1279,1221
0500000US41019,"Douglas County, Oregon",45026,39623,566,35205,3852,5403
0500000US41053,"Polk County, Oregon",29692,27428,266,24899,2263,2264
0500000US41017,"Deschutes County, Oregon",72471,68532,334,61648,6550,3939
0500000US41071,"Yamhill County, Oregon",36197,33131,284,29402,3445,3066
0500000US41035,"Klamath County, Oregon",27402,23873,93,20938,2842,3529
0500000US41003,"Benton County, Oregon",35056,33494,164,31092,2238,1562
0500000US41013,"Crook County, Oregon",9339,8224,59,7295,870,1115
0500000US41025,"Harney County, Oregon",3157,2720,30,2334,356,437
0500000US41063,"Wallowa County, Oregon",3165,2692,12,2343,337,473
0500000US41069,"Wheeler County, Oregon",661,532,2,457,73,129
0500000US41011,"Coos County, Oregon",26640,22665,193,19472,3000,3975
0500000US41027,"Hood River County, Oregon",8539,7744,38,7066,640,795
0500000US41051,"Multnomah County, Oregon",321968,299350,1105,275939,22306,22618
0500000US42055,"Franklin County, Pennsylvania",60210,50814,771,46045,3998,9396
0500000US42009,"Bedford County, Pennsylvania",19674,15305,272,13731,1302,4369
0500000US42111,"Somerset County, Pennsylvania",29708,23342,267,20492,2583,6366
0500000US42133,"York County, Pennsylvania",171244,149292,1332,133616,14344,21952
0500000US42015,"Bradford County, Pennsylvania",24812,20948,276,18790,1882,3864
0500000US42029,"Chester County, Pennsylvania",189592,174348,606,164986,8756,15244
0500000US42063,"Indiana County, Pennsylvania",33892,27358,378,24127,2853,6534
0500000US42125,"Washington County, Pennsylvania",84100,72308,539,66456,5313,11792
0500000US42103,"Pike County, Pennsylvania",21871,19966,110,18560,1296,1905
0500000US42077,"Lehigh County, Pennsylvania",138008,121827,974,110969,9884,16181
0500000US42031,"Clarion County, Pennsylvania",15824,13095,178,11839,1078,2729
0500000US42033,"Clearfield County, Pennsylvania",31349,25225,347,21966,2912,6124
0500000US42081,"Lycoming County, Pennsylvania",45897,39088,444,34435,4209,6809
0500000US42123,"Warren County, Pennsylvania",17080,14327,208,12465,1654,2753
0500000US42047,"Elk County, Pennsylvania",13727,11562,149,10328,1085,2165
0500000US42085,"Mercer County, Pennsylvania",46028,38259,398,34624,3237,7769
0500000US42113,"Sullivan County, Pennsylvania",2721,2213,58,1915,240,508
0500000US44003,"Kent County, Rhode Island",68833,61595,127,57968,3500,7238
0500000US44009,"Washington County, Rhode Island",49111,44929,121,42625,2183,4182
0500000US45073,"Oconee County, South Carolina",31818,26579,201,22519,3859,5239
0500000US45005,"Allendale County, South Carolina",3350,2321,20,1612,689,1029
0500000US45023,"Chester County, South Carolina",12453,9259,155,6791,2313,3194
0500000US45067,"Marion County, South Carolina",11538,8148,80,5328,2740,3390
0500000US45019,"Charleston County, South Carolina",156482,141819,393,119474,21952,14663
0500000US45069,"Marlboro County, South Carolina",9584,6786,76,5306,1404,2798
0500000US45021,"Cherokee County, South Carolina",20373,15749,97,12283,3369,4624
0500000US45053,"Jasper County, South Carolina",9982,7694,69,6274,1351,2288
0500000US45061,"Lee County, South Carolina",6357,4648,83,3282,1283,1709
0500000US45083,"Spartanburg County, South Carolina",114640,98541,450,86718,11373,16099
0500000US45013,"Beaufort County, South Carolina",70607,65466,497,59525,5444,5141
0500000US45081,"Saluda County, South Carolina",7211,5407,43,4648,716,1804
0500000US46067,"Hutchinson County, South Dakota",2862,2245,33,1910,302,617
0500000US46017,"Buffalo County, South Dakota",564,382,3,297,82,182
0500000US46041,"Dewey County, South Dakota",1667,1022,2,898,122,645
0500000US46065,"Hughes County, South Dakota",7479,6316,10,5864,442,1163
0500000US46111,"Sanborn County, South Dakota",1051,908,12,818,78,143
0500000US46059,"Hand County, South Dakota",1518,1266,8,1116,142,252
0500000US46135,"Yankton County, South Dakota",9359,7946,37,7046,863,1413
0500000US46005,"Beadle County, South Dakota",7770,6451,51,5340,1060,1319
0500000US46035,"Davison County, South Dakota",8687,7594,22,6967,605,1093
0500000US46073,"Jerauld County, South Dakota",917,742,6,650,86,175
0500000US46117,"Stanley County, South Dakota",1264,1044,0,1016,28,220
0500000US46107,"Potter County, South Dakota",998,845,20,739,86,153
0500000US46023,"Charles Mix County, South Dakota",3144,2354,47,1925,382,790
0500000US46091,"Marshall County, South Dakota",1862,1637,10,1374,253,225
0500000US46101,"Moody County, South Dakota",2636,2257,19,1980,258,379
0500000US46121,"Todd County, South Dakota",2703,1674,14,1160,500,1029
0500000US46085,"Lyman County, South Dakota",1404,1157,5,981,171,247
0500000US46115,"Spink County, South Dakota",2635,2231,15,2031,185,404
0500000US46011,"Brookings County, South Dakota",12764,11881,78,10347,1456,883
0500000US46057,"Hamlin County, South Dakota",2215,1976,37,1559,380,239
0500000US47083,"Houston County, Tennessee",2943,2113,39,1849,225,830
0500000US47071,"Hardin County, Tennessee",10267,8008,70,6670,1268,2259
0500000US47069,"Hardeman County, Tennessee",8907,6741,69,5229,1443,2166
0500000US47139,"Polk County, Tennessee",7096,5619,65,4727,827,1477
0500000US47185,"White County, Tennessee",9951,7678,76,6479,1123,2273
0500000US47171,"Unicoi County, Tennessee",7521,5888,91,4923,874,1633
0500000US47183,"Weakley County, Tennessee",13605,11114,72,9431,1611,2491
0500000US47007,"Bledsoe County, Tennessee",4853,3818,8,3151,659,1035
0500000US47031,"Coffee County, Tennessee",21626,18515,80,14667,3768,3111
0500000US47073,"Hawkins County, Tennessee",23330,18573,203,14831,3539,4757
0500000US47111,"Macon County, Tennessee",9202,6955,77,5636,1242,2247
0500000US47147,"Robertson County, Tennessee",25388,22116,113,20161,1842,3272
0500000US47021,"Cheatham County, Tennessee",14952,12923,68,11564,1291,2029
0500000US47055,"Giles County, Tennessee",11496,9626,109,7690,1827,1870
0500000US47113,"Madison County, Tennessee",37729,31776,100,27231,4445,5953
0500000US47137,"Pickett County, Tennessee",2218,1764,57,1574,133,454
0500000US47181,"Wayne County, Tennessee",5954,4324,78,3693,553,1630
0500000US47003,"Bedford County, Tennessee",16882,14220,53,11792,2375,2662
0500000US47035,"Cumberland County, Tennessee",25347,21184,204,18726,2254,4163
0500000US47025,"Claiborne County, Tennessee",13238,9785,124,7901,1760,3453
0500000US47085,"Humphreys County, Tennessee",6858,5121,48,4391,682,1737
0500000US47141,"Putnam County, Tennessee",31110,26149,204,22873,3072,4961
0500000US47161,"Stewart County, Tennessee",5246,4099,29,3427,643,1147
0500000US47039,"Decatur County, Tennessee",4623,3570,34,2970,566,1053
0500000US47109,"McNairy County, Tennessee",10022,7721,48,6413,1260,2301
0500000US48317,"Martin County, Texas",1626,1394,3,1059,332,232
0500000US47011,"Bradley County, Tennessee",39840,33612,265,30133,3214,6228
0500000US48267,"Kimble County, Texas",1948,1615,11,1295,309,333
0500000US48467,"Van Zandt County, Texas",19615,16450,133,12923,3394,3165
0500000US48501,"Yoakum County, Texas",2676,2345,0,1962,383,331
0500000US48387,"Red River County, Texas",5048,3705,68,3064,573,1343
0500000US48435,"Sutton County, Texas",1484,1163,0,847,316,321
0500000US48459,"Upshur County, Texas",14036,11921,99,10479,1343,2115
0500000US48481,"Wharton County, Texas",15256,12257,186,9903,2168,2999
0500000US48033,"Borden County, Texas",261,231,3,202,26,30
0500000US48315,"Marion County, Texas",4459,3231,35,2632,564,1228
0500000US48181,"Grayson County, Texas",47957,41553,294,35163,6096,6404
0500000US48363,"Palo Pinto County, Texas",10312,8743,53,7357,1333,1569
0500000US48123,"DeWitt County, Texas",7088,5315,61,4477,777,1773
0500000US48059,"Callahan County, Texas",5319,4045,102,3389,554,1274
0500000US48183,"Gregg County, Texas",45532,39794,409,33958,5427,5738
0500000US48303,"Lubbock County, Texas",112185,100922,476,85366,15080,11263
0500000US48257,"Kaufman County, Texas",37364,33245,159,28650,4436,4119
0500000US48153,"Floyd County, Texas",2328,1875,26,1674,175,453
0500000US48071,"Chambers County, Texas",13529,11805,47,10802,956,1724
0500000US48027,"Bell County, Texas",120241,109787,281,97869,11637,10454
0500000US48233,"Hutchinson County, Texas",7191,6237,18,5546,673,954
0500000US48361,"Orange County, Texas",31989,27681,51,24396,3234,4308
0500000US48495,"Winkler County, Texas",2572,2085,31,1740,314,487
0500000US48053,"Burnet County, Texas",16849,15022,78,12620,2324,1827
0500000US48113,"Dallas County, Texas",917276,813386,2277,714557,96552,103890
0500000US48311,"McMullen County, Texas",223,178,0,147,31,45
0500000US48251,"Johnson County, Texas",56433,51583,432,46180,4971,4850
0500000US48205,"Hartley County, Texas",1681,1510,3,1296,211,171
0500000US48293,"Limestone County, Texas",8169,6312,46,4941,1325,1857
0500000US48367,"Parker County, Texas",44255,41034,192,36821,4021,3221
0500000US48109,"Culberson County, Texas",681,445,17,314,114,236
0500000US48169,"Garza County, Texas",1628,1409,0,1258,151,219
0500000US48453,"Travis County, Texas",458484,432018,939,394536,36543,26466
0500000US48087,"Collingsworth County, Texas",1055,911,7,713,191,144
0500000US48279,"Lamb County, Texas",4754,3869,30,3067,772,885
0500000US48301,"Loving County, Texas",33,30,0,24,6,3
0500000US28117,"Prentiss County, Mississippi",9399,7035,27,6195,813,2364
0500000US28059,"Jackson County, Mississippi",51429,44498,348,38688,5462,6931
0500000US28143,"Tunica County, Mississippi",3943,3248,4,2547,697,695
0500000US28021,"Claiborne County, Mississippi",3009,2074,25,1830,219,935
0500000US28075,"Lauderdale County, Mississippi",29657,23864,74,19289,4501,5793
0500000US28127,"Simpson County, Mississippi",9361,6901,27,5185,1689,2460
0500000US28007,"Attala County, Mississippi",7129,5525,22,4296,1207,1604
0500000US28027,"Coahoma County, Mississippi",8744,6389,115,5051,1223,2355
0500000US28147,"Walthall County, Mississippi",5683,3949,11,2667,1271,1734
0500000US28115,"Pontotoc County, Mississippi",10788,8491,5,6391,2095,2297
0500000US28003,"Alcorn County, Mississippi",14502,11860,95,9544,2221,2642
0500000US28033,"DeSoto County, Mississippi",62078,56566,224,51452,4890,5512
0500000US29129,"Mercer County, Missouri",1326,974,7,858,109,352
0500000US29047,"Clay County, Missouri",90285,84130,369,77643,6118,6155
0500000US29065,"Dent County, Missouri",6300,4910,28,4031,851,1390
0500000US29227,"Worth County, Missouri",856,666,2,597,67,190
0500000US29510,"St. Louis city, Missouri",140455,116238,300,98334,17604,24217
0500000US29023,"Butler County, Missouri",16357,13486,44,11435,2007,2871
0500000US29087,"Holt County, Missouri",2056,1639,23,1378,238,417
0500000US29139,"Montgomery County, Missouri",4891,3942,54,3218,670,949
0500000US29207,"Stoddard County, Missouri",11684,9592,20,8235,1337,2092
0500000US29221,"Washington County, Missouri",9114,7162,112,5627,1423,1952
0500000US29063,"DeKalb County, Missouri",3812,3124,31,2694,399,688
0500000US29107,"Lafayette County, Missouri",12959,11095,120,9399,1576,1864
0500000US29197,"Schuyler County, Missouri",1588,1198,14,904,280,390
0500000US29029,"Camden County, Missouri",16096,14139,178,12211,1750,1957
0500000US29097,"Jasper County, Missouri",45261,38762,158,32149,6455,6499
0500000US29119,"McDonald County, Missouri",8110,6209,113,3966,2130,1901
0500000US29167,"Polk County, Missouri",11557,9761,101,8595,1065,1796
0500000US29179,"Reynolds County, Missouri",2638,2124,51,1839,234,514
0500000US29201,"Scott County, Missouri",15428,12673,22,11240,1411,2755
0500000US29011,"Barton County, Missouri",4931,3886,50,3096,740,1045
0500000US29051,"Cole County, Missouri",29749,26125,246,20268,5611,3624
0500000US29073,"Gasconade County, Missouri",6116,5182,81,4524,577,934
0500000US29121,"Macon County, Missouri",5889,4645,74,3799,772,1244
0500000US29155,"Pemiscot County, Missouri",6845,5187,11,4532,644,1658
0500000US29203,"Shannon County, Missouri",3173,2289,35,1800,454,884
0500000US29067,"Douglas County, Missouri",5126,3893,137,3051,705,1233
0500000US29083,"Henry County, Missouri",9199,7675,86,6656,933,1524
0500000US29109,"Lawrence County, Missouri",14604,12281,99,10446,1736,2323
0500000US30015,"Chouteau County, Montana",2256,1725,11,1582,132,531
0500000US30053,"Lincoln County, Montana",8259,6693,58,5761,874,1566
0500000US30103,"Treasure County, Montana",365,324,28,252,44,41
0500000US30097,"Sweet Grass County, Montana",1547,1253,16,1101,136,294
0500000US30079,"Prairie County, Montana",540,428,10,398,20,112
0500000US30035,"Glacier County, Montana",4178,2800,54,2386,360,1378
0500000US30037,"Golden Valley County, Montana",337,273,8,239,26,64
0500000US30095,"Stillwater County, Montana",3716,3307,34,2969,304,409
0500000US30039,"Granite County, Montana",1280,1051,12,941,98,229
0500000US30057,"Madison County, Montana",3481,2945,22,2467,456,536
0500000US30091,"Sheridan County, Montana",1645,1487,8,1291,188,158
0500000US30003,"Big Horn County, Montana",3687,2787,44,2225,518,900
0500000US30033,"Garfield County, Montana",447,352,6,313,33,95
0500000US30049,"Lewis and Clark County, Montana",27800,24677,173,22070,2434,3123
0500000US30063,"Missoula County, Montana",48608,44822,269,40676,3877,3786
0500000US30013,"Cascade County, Montana",34444,28459,165,25508,2786,5985
0500000US30077,"Powell County, Montana",2388,2064,18,1663,383,324
0500000US30031,"Gallatin County, Montana",41985,39616,195,36008,3413,2369
0500000US30001,"Beaverhead County, Montana",3977,3499,26,2933,540,478
0500000US30065,"Musselshell County, Montana",2077,1616,11,1489,116,461
0500000US31161,"Sheridan County, Nebraska",2251,1745,36,1501,208,506
0500000US31129,"Nuckolls County, Nebraska",1914,1577,31,1381,165,337
0500000US31063,"Frontier County, Nebraska",1116,886,8,755,123,230
0500000US31055,"Douglas County, Nebraska",215787,192064,837,177457,13770,23723
0500000US31029,"Chase County, Nebraska",1714,1498,0,1388,110,216
0500000US31005,"Arthur County, Nebraska",193,158,3,138,17,35
0500000US31061,"Franklin County, Nebraska",1354,1114,14,961,139,240
0500000US31095,"Jefferson County, Nebraska",3283,2635,38,2326,271,648
0500000US31115,"Loup County, Nebraska",279,238,0,192,46,41
0500000US31137,"Phelps County, Nebraska",3927,3456,23,2998,435,471
0500000US31157,"Scotts Bluff County, Nebraska",14613,12503,101,10934,1468,2110
0500000US31105,"Kimball County, Nebraska",1571,1330,16,1072,242,241
0500000US31121,"Merrick County, Nebraska",3324,2714,50,2320,344,610
0500000US31021,"Burt County, Nebraska",2919,2313,15,1990,308,606
0500000US31039,"Cuming County, Nebraska",3752,3030,70,2458,502,722
0500000US31075,"Grant County, Nebraska",293,246,1,211,34,47
0500000US31085,"Hayes County, Nebraska",413,347,3,312,32,66
0500000US31027,"Cedar County, Nebraska",3456,2895,14,2697,184,561
0500000US31097,"Johnson County, Nebraska",1820,1458,17,1289,152,362
0500000US31071,"Garfield County, Nebraska",886,684,0,535,149,202
0500000US31133,"Pawnee County, Nebraska",1219,900,18,809,73,319
0500000US31183,"Wheeler County, Nebraska",357,308,10,255,43,49
0500000US31185,"York County, Nebraska",5691,4912,69,4404,439,779
0500000US31037,"Colfax County, Nebraska",3718,3046,28,2718,300,672
0500000US31113,"Logan County, Nebraska",341,284,1,239,44,57
0500000US31143,"Polk County, Nebraska",2052,1790,18,1670,102,262
0500000US31017,"Brown County, Nebraska",1434,1153,14,1011,128,281
0500000US32015,"Lander County, Nevada",2087,1778,11,1575,192,309
0500000US32011,"Eureka County, Nevada",750,634,0,577,57,116
0500000US34021,"Mercer County, New Jersey",129873,116909,365,105254,11290,12964
0500000US34035,"Somerset County, New Jersey",117012,109951,391,105714,3846,7061
0500000US34001,"Atlantic County, New Jersey",99874,88675,445,79601,8629,11199
0500000US34023,"Middlesex County, New Jersey",284174,259669,1049,239524,19096,24505
0500000US34009,"Cape May County, New Jersey",39904,35522,158,32712,2652,4382
0500000US34039,"Union County, New Jersey",188987,167721,645,152841,14235,21266
0500000US34019,"Hunterdon County, New Jersey",47180,44125,333,41976,1816,3055
0500000US35028,"Los Alamos County, New Mexico",7567,6894,55,6484,355,673
0500000US35061,"Valencia County, New Mexico",27489,22295,201,18144,3950,5194
0500000US35001,"Bernalillo County, New Mexico",265657,234830,1540,204900,28390,30827
0500000US35011,"De Baca County, New Mexico",705,549,0,444,105,156
0500000US35023,"Hidalgo County, New Mexico",1753,1311,9,1091,211,442
0500000US35043,"Sandoval County, New Mexico",50340,44582,547,40369,3666,5758
0500000US35009,"Curry County, New Mexico",18515,16164,50,14236,1878,2351
0500000US35021,"Harding County, New Mexico",211,127,0,104,23,84
0500000US35045,"San Juan County, New Mexico",43134,33841,455,26758,6628,9293
0500000US35005,"Chaves County, New Mexico",23169,18925,155,15982,2788,4244
0500000US35059,"Union County, New Mexico",1381,929,10,783,136,452
0500000US35041,"Roosevelt County, New Mexico",6993,6010,10,5158,842,983
0500000US36005,"Bronx County, New York",499728,421086,1134,353733,66219,78642
0500000US36035,"Fulton County, New York",22439,19075,169,16570,2336,3364
0500000US36083,"Rensselaer County, New York",64563,58188,244,53522,4422,6375
0500000US36027,"Dutchess County, New York",107347,97823,492,90997,6334,9524
0500000US36043,"Herkimer County, New York",24583,20773,202,18529,2042,3810
0500000US36089,"St. Lawrence County, New York",41669,35654,272,32237,3145,6015
0500000US36113,"Warren County, New York",27553,24309,179,22342,1788,3244
0500000US36055,"Monroe County, New York",300796,265657,1453,243660,20544,35139
0500000US36111,"Ulster County, New York",69539,62356,326,57813,4217,7183
0500000US36051,"Livingston County, New York",24383,21692,208,19637,1847,2691
0500000US36039,"Greene County, New York",17117,14197,163,12198,1836,2920
0500000US36003,"Allegany County, New York",18009,15024,262,12895,1867,2985
0500000US36009,"Cattaraugus County, New York",31433,25462,291,21562,3609,5971
0500000US36093,"Schenectady County, New York",53295,47563,134,43638,3791,5732
0500000US36123,"Yates County, New York",9029,7217,56,6400,761,1812
0500000US37087,"Haywood County, North Carolina",26336,21776,135,18054,3587,4560
0500000US37005,"Alleghany County, North Carolina",4746,3689,6,3330,353,1057
0500000US37045,"Cleveland County, North Carolina",36882,28032,147,22920,4965,8850
0500000US37077,"Granville County, North Carolina",21030,17949,96,15613,2240,3081
0500000US37093,"Hoke County, North Carolina",17722,15308,76,13730,1502,2414
0500000US37097,"Iredell County, North Carolina",65246,58078,363,51673,6042,7168
0500000US37147,"Pitt County, North Carolina",69169,60675,213,53494,6968,8494
0500000US37039,"Cherokee County, North Carolina",11895,9745,91,8247,1407,2150
0500000US37193,"Wilkes County, North Carolina",28355,23071,195,20023,2853,5284
0500000US37003,"Alexander County, North Carolina",13722,10790,43,9466,1281,2932
0500000US37031,"Carteret County, North Carolina",29690,26781,105,24242,2434,2909
0500000US37139,"Pasquotank County, North Carolina",14780,12470,88,10792,1590,2310
0500000US37173,"Swain County, North Carolina",5443,3620,38,2732,850,1823
0500000US37007,"Anson County, North Carolina",9516,7482,62,6537,883,2034
0500000US37069,"Franklin County, North Carolina",24749,20902,145,18437,2320,3847
0500000US37113,"Macon County, North Carolina",15699,12892,162,11012,1718,2807
0500000US37175,"Transylvania County, North Carolina",14123,12590,32,11010,1548,1533
0500000US37047,"Columbus County, North Carolina",22306,16590,162,13576,2852,5716
0500000US37123,"Montgomery County, North Carolina",10411,7874,105,6846,923,2537
0500000US37153,"Richmond County, North Carolina",18546,14458,81,12738,1639,4088
0500000US37171,"Surry County, North Carolina",28985,22398,310,17917,4171,6587
0500000US37021,"Buncombe County, North Carolina",107093,93742,316,85734,7692,13351
0500000US37025,"Cabarrus County, North Carolina",72299,66893,352,63069,3472,5406
0500000US37057,"Davidson County, North Carolina",65471,55455,325,49126,6004,10016
0500000US37091,"Hertford County, North Carolina",8899,6828,60,5277,1491,2071
0500000US37141,"Pender County, North Carolina",21766,19171,197,16306,2668,2595
0500000US37189,"Watauga County, North Carolina",20355,18141,82,16341,1718,2214
0500000US37177,"Tyrrell County, North Carolina",1631,1191,0,986,205,440
0500000US38097,"Traill County, North Dakota",3349,2960,5,2642,313,389
0500000US38021,"Dickey County, North Dakota",2170,1961,11,1718,232,209
0500000US38101,"Ward County, North Dakota",27564,25107,110,23272,1725,2457
0500000US38049,"McHenry County, North Dakota",2628,2232,28,2009,195,396
0500000US38005,"Benson County, North Dakota",2285,1731,5,1283,443,554
0500000US38075,"Renville County, North Dakota",1022,906,3,777,126,116
0500000US38015,"Burleigh County, North Dakota",39495,35630,161,32065,3404,3865
0500000US38065,"Oliver County, North Dakota",750,643,0,551,92,107
0500000US38071,"Ramsey County, North Dakota",5003,4101,30,3543,528,902
0500000US38039,"Griggs County, North Dakota",1056,829,0,742,87,227
0500000US38083,"Sheridan County, North Dakota",689,534,8,431,95,155
0500000US38103,"Wells County, North Dakota",1960,1581,12,1445,124,379
0500000US39099,"Mahoning County, Ohio",98052,82926,471,74612,7843,15126
0500000US39145,"Scioto County, Ohio",30086,23898,421,20868,2609,6188
0500000US39105,"Meigs County, Ohio",9193,7345,82,5991,1272,1848
0500000US39131,"Pike County, Ohio",10822,8943,49,7691,1203,1879
0500000US39061,"Hamilton County, Ohio",339966,298692,1803,272308,24581,41274
0500000US39043,"Erie County, Ohio",31301,27313,142,24465,2706,3988
0500000US39087,"Lawrence County, Ohio",23540,19169,254,16604,2311,4371
0500000US39157,"Tuscarawas County, Ohio",36817,30294,218,26586,3490,6523
0500000US39015,"Brown County, Ohio",17434,14900,152,12716,2032,2534
0500000US39089,"Licking County, Ohio",64016,57179,321,52462,4396,6837
0500000US39019,"Carroll County, Ohio",11126,9267,135,8057,1075,1859
0500000US39025,"Clermont County, Ohio",77181,70105,459,64073,5573,7076
0500000US39071,"Highland County, Ohio",16646,13293,128,10952,2213,3353
0500000US39133,"Portage County, Ohio",61993,55589,233,49103,6253,6404
0500000US39013,"Belmont County, Ohio",26200,21243,192,18304,2747,4957
0500000US39127,"Perry County, Ohio",13547,11254,198,9422,1634,2293
0500000US48019,"Bandera County, Texas",8242,7210,67,6403,740,1032
0500000US48395,"Robertson County, Texas",6358,5282,8,4512,762,1076
0500000US48441,"Taylor County, Texas",49482,44128,108,36637,7383,5354
0500000US48455,"Trinity County, Texas",5918,4704,88,3593,1023,1214
0500000US48079,"Cochran County, Texas",996,747,4,595,148,249
0500000US48091,"Comal County, Texas",48903,44974,100,42220,2654,3929
0500000US48225,"Houston County, Texas",8209,6115,61,4426,1628,2094
0500000US48375,"Potter County, Texas",43944,37099,123,30244,6732,6845
0500000US48415,"Scurry County, Texas",5884,5093,29,4115,949,791
0500000US48103,"Crane County, Texas",1422,1294,6,1011,277,128
0500000US48433,"Stonewall County, Texas",582,465,4,404,57,117
0500000US48049,"Brown County, Texas",14016,11367,76,9885,1406,2649
0500000US48025,"Bee County, Texas",8537,7056,40,5076,1940,1481
0500000US48307,"McCulloch County, Texas",3255,2740,18,2387,335,515
0500000US48287,"Lee County, Texas",6104,5199,23,4510,666,905
0500000US48139,"Ellis County, Texas",55840,51877,146,47021,4710,3963
0500000US48265,"Kerr County, Texas",20766,18090,181,16142,1767,2676
0500000US48145,"Falls County, Texas",5237,3800,50,2980,770,1437
0500000US19137,"Montgomery County, Iowa",4587,3973,22,3448,503,614
0500000US19123,"Mahaska County, Iowa",8829,7598,63,6867,668,1231
0500000US19019,"Buchanan County, Iowa",8046,6842,107,6149,586,1204
0500000US19053,"Decatur County, Iowa",3213,2571,16,2223,332,642
0500000US20085,"Jackson County, Kansas",5392,4575,39,4135,401,817
0500000US20109,"Logan County, Kansas",1137,963,6,874,83,174
0500000US20209,"Wyandotte County, Kansas",59983,51414,187,42515,8712,8569
0500000US20027,"Clay County, Kansas",3402,2762,27,2329,406,640
0500000US20169,"Saline County, Kansas",22210,19038,103,17105,1830,3172
0500000US20197,"Wabaunsee County, Kansas",2749,2294,45,2060,189,455
0500000US20123,"Mitchell County, Kansas",2616,2206,13,1992,201,410
0500000US20005,"Atchison County, Kansas",5980,4834,62,4195,577,1146
0500000US20055,"Finney County, Kansas",12509,10821,29,9601,1191,1688
0500000US20103,"Leavenworth County, Kansas",27060,24601,117,21743,2741,2459
0500000US20187,"Stanton County, Kansas",807,670,0,556,114,137
0500000US20119,"Meade County, Kansas",1675,1424,0,1286,138,251
0500000US20151,"Pratt County, Kansas",3684,3149,15,2674,460,535
0500000US20003,"Anderson County, Kansas",3069,2398,53,1994,351,671
0500000US20061,"Geary County, Kansas",12754,11787,71,10414,1302,967
0500000US20057,"Ford County, Kansas",11274,9682,2,8334,1346,1592
0500000US20117,"Marshall County, Kansas",4112,3394,28,2965,401,718
0500000US20023,"Cheyenne County, Kansas",1228,1024,15,925,84,204
0500000US20035,"Cowley County, Kansas",13566,11672,105,9793,1774,1894
0500000US20059,"Franklin County, Kansas",9982,8501,47,6832,1622,1481
0500000US20089,"Jewell County, Kansas",1380,1054,0,909,145,326
0500000US20159,"Rice County, Kansas",3863,3187,19,2839,329,676
0500000US20017,"Chase County, Kansas",1029,831,4,722,105,198
0500000US20203,"Wichita County, Kansas",903,820,3,684,133,83
0500000US20137,"Norton County, Kansas",1930,1581,20,1451,110,349
0500000US20009,"Barton County, Kansas",10892,9288,93,7864,1331,1604
0500000US20047,"Edwards County, Kansas",1302,1064,19,850,195,238
0500000US20165,"Rush County, Kansas",1403,1147,2,1002,143,256
0500000US20115,"Marion County, Kansas",4789,3987,39,3432,516,802
0500000US20143,"Ottawa County, Kansas",2420,1970,60,1624,286,450
0500000US20007,"Barber County, Kansas",1960,1720,36,1416,268,240
0500000US20041,"Dickinson County, Kansas",7801,6517,45,5667,805,1284
0500000US21223,"Trimble County, Kentucky",3604,3022,15,2384,623,582
0500000US21105,"Hickman County, Kentucky",1855,1317,38,1081,198,538
0500000US21179,"Nelson County, Kentucky",17491,15099,99,13581,1419,2392
0500000US21081,"Grant County, Kentucky",8849,7127,110,5840,1177,1722
0500000US21141,"Logan County, Kentucky",10565,7537,41,6440,1056,3028
0500000US21191,"Pendleton County, Kentucky",5260,4377,68,3552,757,883
0500000US21215,"Spencer County, Kentucky",6709,6221,0,5857,364,488
0500000US21011,"Bath County, Kentucky",4624,3635,15,3170,450,989
0500000US21021,"Boyle County, Kentucky",10984,9217,29,8191,997,1767
0500000US21095,"Harlan County, Kentucky",11213,8192,48,6872,1272,3021
0500000US21137,"Lincoln County, Kentucky",9706,7210,15,6032,1163,2496
0500000US21171,"Monroe County, Kentucky",4414,3208,100,2762,346,1206
0500000US21225,"Union County, Kentucky",5465,4409,20,3748,641,1056
0500000US21035,"Calloway County, Kentucky",14641,12817,37,11235,1545,1824
0500000US21059,"Daviess County, Kentucky",39808,34538,238,31029,3271,5270
0500000US21199,"Pulaski County, Kentucky",25663,20306,226,17030,3050,5357
0500000US21101,"Henderson County, Kentucky",18480,15240,61,13332,1847,3240
0500000US21119,"Knott County, Kentucky",6348,4861,88,3929,844,1487
0500000US21177,"Muhlenberg County, Kentucky",11317,8818,44,7671,1103,2499
0500000US21001,"Adair County, Kentucky",7020,5340,85,4606,649,1680
0500000US21057,"Cumberland County, Kentucky",2769,2070,73,1668,329,699
0500000US21129,"Lee County, Kentucky",2864,1940,0,1532,408,924
0500000US21135,"Lewis County, Kentucky",5435,3990,46,3487,457,1445
0500000US21239,"Woodford County, Kentucky",10198,9197,69,8311,817,1001
0500000US21113,"Jessamine County, Kentucky",18773,16800,72,15245,1483,1973
0500000US21133,"Letcher County, Kentucky",9892,7734,50,6568,1116,2158
0500000US21145,"McCracken County, Kentucky",27841,23075,64,20816,2195,4766
0500000US21235,"Whitley County, Kentucky",12490,8948,6,7615,1327,3542
0500000US21071,"Floyd County, Kentucky",15163,12018,31,10185,1802,3145
0500000US21147,"McCreary County, Kentucky",6203,4273,63,3229,981,1930
0500000US21169,"Metcalfe County, Kentucky",3998,3220,10,2839,371,778
0500000US21205,"Rowan County, Kentucky",8505,7317,48,6777,492,1188
0500000US21049,"Clark County, Kentucky",14427,12424,42,10701,1681,2003
0500000US21041,"Carroll County, Kentucky",3981,3074,30,2439,605,907
0500000US21065,"Estill County, Kentucky",5503,4187,36,3503,648,1316
0500000US21089,"Greenup County, Kentucky",14057,12107,95,10763,1249,1950
0500000US21043,"Carter County, Kentucky",9972,7154,86,5675,1393,2818
0500000US22057,"Lafourche Parish, Louisiana",36449,30810,35,26985,3790,5639
0500000US22053,"Jefferson Davis Parish, Louisiana",11501,9113,41,7740,1332,2388
0500000US22125,"West Feliciana Parish, Louisiana",3908,3436,5,2551,880,472
0500000US22011,"Beauregard Parish, Louisiana",13219,11419,84,9630,1705,1800
0500000US22039,"Evangeline Parish, Louisiana",12051,8971,9,7454,1508,3080
0500000US22061,"Lincoln Parish, Louisiana",17551,15121,97,13875,1149,2430
0500000US22119,"Webster Parish, Louisiana",16230,11191,76,7802,3313,5039
0500000US22047,"Iberville Parish, Louisiana",10918,9013,13,7724,1276,1905
0500000US22067,"Morehouse Parish, Louisiana",9758,6110,162,4844,1104,3648
0500000US22109,"Terrebonne Parish, Louisiana",40014,34373,160,28463,5750,5641
0500000US22027,"Claiborne Parish, Louisiana",5891,4058,14,2613,1431,1833
0500000US22009,"Avoyelles Parish, Louisiana",15085,11599,193,9620,1786,3486
0500000US22077,"Pointe Coupee Parish, Louisiana",8961,6948,26,5924,998,2013
0500000US22115,"Vernon Parish, Louisiana",17801,15325,51,12922,2352,2476
0500000US22085,"Sabine Parish, Louisiana",9185,6348,180,4929,1239,2837
0500000US22059,"LaSalle Parish, Louisiana",5018,3841,0,3423,418,1177
0500000US23015,"Lincoln County, Maine",15372,13854,224,11923,1707,1518
0500000US23021,"Piscataquis County, Maine",7357,6026,158,4888,980,1331
0500000US23029,"Washington County, Maine",13806,11391,183,9732,1476,2415
0500000US23023,"Sagadahoc County, Maine",15833,14250,90,12962,1198,1583
0500000US23011,"Kennebec County, Maine",51542,44933,400,40631,3902,6609
0500000US23009,"Hancock County, Maine",23579,20851,288,18431,2132,2728
0500000US24039,"Somerset County, Maryland",8383,6817,67,5644,1106,1566
0500000US24001,"Allegany County, Maryland",27837,22281,171,20075,2035,5556
0500000US24033,"Prince George's County, Maryland",308849,288873,927,261839,26107,19976
0500000US24021,"Frederick County, Maryland",91405,83914,491,78905,4518,7491
0500000US24029,"Kent County, Maryland",7910,6585,21,5764,800,1325
0500000US25027,"Worcester County, Massachusetts",307294,275558,1280,255920,18358,31736
0500000US26033,"Chippewa County, Michigan",14046,11790,130,10410,1250,2256
0500000US26125,"Oakland County, Michigan",501260,464168,1377,434419,28372,37092
0500000US26121,"Muskegon County, Michigan",65619,56727,477,49743,6507,8892
0500000US26087,"Lapeer County, Michigan",33320,29582,287,26040,3255,3738
0500000US26151,"Sanilac County, Michigan",17179,14158,195,11739,2224,3021
0500000US26131,"Ontonagon County, Michigan",2876,2246,40,1837,369,630
0500000US26001,"Alcona County, Michigan",5008,4025,67,3386,572,983
0500000US26079,"Kalkaska County, Michigan",7139,6065,117,4987,961,1074
0500000US26065,"Ingham County, Michigan",112200,102337,561,89199,12577,9863
0500000US26129,"Ogemaw County, Michigan",9296,7728,120,6519,1089,1568
0500000US26165,"Wexford County, Michigan",13053,10957,103,9147,1707,2096
0500000US26043,"Dickinson County, Michigan",11087,9250,85,8102,1063,1837
0500000US26109,"Menominee County, Michigan",10665,8655,100,7571,984,2010
0500000US26113,"Missaukee County, Michigan",6027,5052,73,4252,727,975
0500000US26159,"Van Buren County, Michigan",29013,24874,194,21422,3258,4139
0500000US26015,"Barry County, Michigan",23840,20839,260,18458,2121,3001
0500000US26019,"Benzie County, Michigan",6733,5933,61,5368,504,800
0500000US26153,"Schoolcraft County, Michigan",3351,2706,58,2251,397,645
0500000US26055,"Grand Traverse County, Michigan",37134,33939,156,31058,2725,3195
0500000US26049,"Genesee County, Michigan",167889,142303,689,124182,17432,25586
0500000US26093,"Livingston County, Michigan",71180,66274,279,60797,5198,4906
0500000US26101,"Manistee County, Michigan",9591,8024,70,7056,898,1567
0500000US26051,"Gladwin County, Michigan",10999,8455,142,7107,1206,2544
0500000US05075,"Lawrence County, Arkansas",6531,5087,16,4079,992,1444
0500000US05029,"Conway County, Arkansas",8475,6592,34,5065,1493,1883
0500000US05001,"Arkansas County, Arkansas",7682,6067,20,4760,1287,1615
0500000US05085,"Lonoke County, Arkansas",26868,23430,142,20671,2617,3438
0500000US06047,"Merced County, California",79606,70974,469,62693,7812,8632
0500000US06049,"Modoc County, California",3660,2779,0,2503,276,881
0500000US06027,"Inyo County, California",8083,7256,17,6270,969,827
0500000US06099,"Stanislaus County, California",172682,155165,631,141707,12827,17517
0500000US06103,"Tehama County, California",24025,19945,214,16941,2790,4080
0500000US06069,"San Benito County, California",17740,16658,61,15601,996,1082
0500000US06017,"El Dorado County, California",69172,64430,464,59114,4852,4742
0500000US06075,"San Francisco County, California",359673,330605,976,307971,21658,29068
0500000US06107,"Tulare County, California",136106,114238,735,98180,15323,21868
0500000US06057,"Nevada County, California",40904,37429,269,34270,2890,3475
0500000US06039,"Madera County, California",44759,39082,192,34039,4851,5677
0500000US06105,"Trinity County, California",5796,4750,64,3842,844,1046
0500000US06071,"San Bernardino County, California",630633,574948,2160,511244,61544,55685
0500000US06061,"Placer County, California",140661,132400,664,123709,8027,8261
0500000US06095,"Solano County, California",149067,138661,395,131255,7011,10406
0500000US06011,"Colusa County, California",7113,5976,31,5474,471,1137
0500000US06031,"Kings County, California",42735,37560,204,32754,4602,5175
0500000US06019,"Fresno County, California",304624,267065,1240,235023,30802,37559
0500000US06111,"Ventura County, California",271226,249158,679,233889,14590,22068
0500000US08123,"Weld County, Colorado",102101,94084,603,85042,8439,8017
0500000US08027,"Custer County, Colorado",2083,1945,12,1711,222,138
0500000US08035,"Douglas County, Colorado",117426,115051,356,111874,2821,2375
0500000US08067,"La Plata County, Colorado",21793,19458,167,16721,2570,2335
0500000US08105,"Rio Grande County, Colorado",4504,3387,41,2857,489,1117
0500000US08011,"Bent County, Colorado",1744,1430,9,1276,145,314
0500000US08111,"San Juan County, Colorado",266,231,9,205,17,35
0500000US08075,"Logan County, Colorado",8183,7091,34,6439,618,1092
0500000US08119,"Teller County, Colorado",10183,9583,104,8841,638,600
0500000US08039,"Elbert County, Colorado",9046,8594,50,8078,466,452
0500000US08073,"Lincoln County, Colorado",1520,1314,24,1171,119,206
0500000US08003,"Alamosa County, Colorado",6153,5215,67,4394,754,938
0500000US08043,"Fremont County, Colorado",17163,14985,165,13450,1370,2178
0500000US08085,"Montrose County, Colorado",17125,14442,160,12744,1538,2683
0500000US08109,"Saguache County, Colorado",2645,2196,22,1683,491,449
0500000US08053,"Hinsdale County, Colorado",387,343,4,263,76,44
0500000US08049,"Grand County, Colorado",5823,5233,0,5063,170,590
0500000US08089,"Otero County, Colorado",7691,6338,12,5338,988,1353
0500000US09005,"Litchfield County, Connecticut",73987,66866,382,62515,3969,7121
0500000US09011,"New London County, Connecticut",107402,96607,405,90645,5557,10795
0500000US12129,"Wakulla County, Florida",11068,9984,19,8394,1571,1084
0500000US09001,"Fairfield County, Connecticut",340491,312456,1103,293743,17610,28035
0500000US10001,"Kent County, Delaware",64545,58034,267,53390,4377,6511
0500000US12057,"Hillsborough County, Florida",516478,475205,1087,434808,39310,41273
0500000US12045,"Gulf County, Florida",5359,4491,58,4046,387,868
0500000US12097,"Osceola County, Florida",99158,84857,279,75653,8925,14301
0500000US12131,"Walton County, Florida",26432,23448,144,20858,2446,2984
0500000US12065,"Jefferson County, Florida",5771,4745,29,4000,716,1026
0500000US12049,"Hardee County, Florida",7772,5302,138,4520,644,2470
0500000US12093,"Okeechobee County, Florida",13759,11030,99,8141,2790,2729
0500000US12041,"Gilchrist County, Florida",6511,5353,21,4296,1036,1158
0500000US12001,"Alachua County, Florida",97048,88103,481,80708,6914,8945
0500000US12015,"Charlotte County, Florida",76150,67942,546,62171,5225,8208
0500000US12085,"Martin County, Florida",63865,58030,189,53097,4744,5835
0500000US12115,"Sarasota County, Florida",180551,163345,547,150096,12702,17206
0500000US12017,"Citrus County, Florida",62762,55111,380,49939,4792,7651
0500000US12113,"Santa Rosa County, Florida",61345,57618,291,52798,4529,3727
0500000US12011,"Broward County, Florida",682088,624962,1987,559937,63038,57126
0500000US12087,"Monroe County, Florida",30982,28336,54,24969,3313,2646
0500000US13313,"Whitfield County, Georgia",36043,29960,279,27506,2175,6083
0500000US13285,"Troup County, Georgia",24843,20652,79,17365,3208,4191
0500000US13145,"Harris County, Georgia",12158,10887,186,9818,883,1271
0500000US13321,"Worth County, Georgia",8038,6561,50,5618,893,1477
0500000US13109,"Evans County, Georgia",4006,3198,7,2608,583,808
0500000US13307,"Webster County, Georgia",1101,835,48,613,174,266
0500000US13125,"Glascock County, Georgia",1105,843,10,689,144,262
0500000US13051,"Chatham County, Georgia",108151,98560,293,90039,8228,9591
0500000US13173,"Lanier County, Georgia",3724,2825,0,1880,945,899
0500000US13195,"Madison County, Georgia",10712,8684,76,7461,1147,2028
0500000US13147,"Hart County, Georgia",10019,7811,69,6503,1239,2208
0500000US13191,"McIntosh County, Georgia",6033,5082,96,4241,745,951
0500000US13237,"Putnam County, Georgia",8660,7630,6,6326,1298,1030
0500000US13301,"Warren County, Georgia",2332,1585,9,980,596,747
0500000US13029,"Bryan County, Georgia",12636,11703,77,10776,850,933
0500000US13039,"Camden County, Georgia",19327,17549,61,15980,1508,1778
0500000US13099,"Early County, Georgia",4082,2639,31,2211,397,1443
0500000US13069,"Coffee County, Georgia",14298,10920,71,8638,2211,3378
0500000US13123,"Gilmer County, Georgia",11645,9609,129,8507,973,2036
0500000US13317,"Wilkes County, Georgia",3879,2313,10,1682,621,1566
0500000US13129,"Gordon County, Georgia",20294,16744,52,14074,2618,3550
0500000US13057,"Cherokee County, Georgia",85825,81755,229,78429,3097,4070
0500000US13177,"Lee County, Georgia",10354,9443,16,8486,941,911
0500000US13133,"Greene County, Georgia",7004,5711,28,4681,1002,1293
0500000US13075,"Cook County, Georgia",6233,4752,23,3671,1058,1481
0500000US13121,"Fulton County, Georgia",400016,366411,660,330031,35720,33605
0500000US13187,"Lumpkin County, Georgia",11649,9963,105,8874,984,1686
0500000US13201,"Miller County, Georgia",2300,1432,38,1116,278,868
0500000US13219,"Oconee County, Georgia",13093,12290,54,11242,994,803
0500000US13151,"Henry County, Georgia",73826,70084,126,63870,6088,3742
0500000US13183,"Long County, Georgia",5601,5103,0,4369,734,498
0500000US13257,"Stephens County, Georgia",9468,7743,95,6459,1189,1725
0500000US13293,"Upson County, Georgia",10204,8121,17,6630,1474,2083
0500000US13225,"Peach County, Georgia",10103,8231,26,7340,865,1872
0500000US13229,"Pierce County, Georgia",7072,5835,14,4527,1294,1237
0500000US13251,"Screven County, Georgia",5257,4037,11,3628,398,1220
0500000US13011,"Banks County, Georgia",6603,4999,87,4158,754,1604
0500000US13061,"Clay County, Georgia",1202,866,14,724,128,336
0500000US13089,"DeKalb County, Georgia",277757,256722,579,228762,27381,21035
0500000US13157,"Jackson County, Georgia",22034,18955,146,17020,1789,3079
0500000US13181,"Lincoln County, Georgia",3424,2340,4,1817,519,1084
0500000US13001,"Appling County, Georgia",6682,5129,126,3768,1235,1553
0500000US13235,"Pulaski County, Georgia",3817,3008,20,2482,506,809
0500000US13281,"Towns County, Georgia",4777,3805,19,3429,357,972
0500000US13287,"Turner County, Georgia",3023,2158,0,1909,249,865
0500000US16077,"Power County, Idaho",2581,2315,1,2046,268,266
0500000US16071,"Oneida County, Idaho",1585,1459,18,1328,113,126
0500000US16063,"Lincoln County, Idaho",1687,1383,22,1129,232,304
0500000US16041,"Franklin County, Idaho",4294,3886,38,3549,299,408
0500000US16053,"Jerome County, Idaho",7828,6688,98,5620,970,1140
0500000US16067,"Minidoka County, Idaho",7279,6506,60,5825,621,773
0500000US16013,"Blaine County, Idaho",8190,7550,16,6943,591,640
0500000US16021,"Boundary County, Idaho",4605,4024,65,3391,568,581
0500000US16047,"Gooding County, Idaho",5419,4617,45,3885,687,802
0500000US16007,"Bear Lake County, Idaho",2350,2039,14,1922,103,311
0500000US16019,"Bonneville County, Idaho",39000,36146,251,33300,2595,2854
0500000US16035,"Clearwater County, Idaho",3707,3078,79,2575,424,629
0500000US16059,"Lemhi County, Idaho",3549,3012,40,2698,274,537
0500000US16017,"Bonner County, Idaho",17584,15215,137,12920,2158,2369
0500000US16037,"Custer County, Idaho",1761,1527,60,1326,141,234
0500000US16065,"Madison County, Idaho",10625,10186,59,8040,2087,439
0500000US16081,"Teton County, Idaho",3736,3391,0,3086,305,345
0500000US15003,"Honolulu County, Hawaii",311525,283358,690,263764,18904,28167
0500000US17183,"Vermilion County, Illinois",31180,24663,168,21998,2497,6517
0500000US17023,"Clark County, Illinois",6774,5742,18,4710,1014,1032
0500000US17049,"Effingham County, Illinois",13555,11662,125,10666,871,1893
0500000US17065,"Hamilton County, Illinois",3376,2736,21,2409,306,640
0500000US17087,"Johnson County, Illinois",4342,3147,47,2756,344,1195
0500000US17105,"Livingston County, Illinois",14320,12373,71,11084,1218,1947
0500000US17179,"Tazewell County, Illinois",54613,47844,286,43903,3655,6769
0500000US17187,"Warren County, Illinois",6690,5797,114,5226,457,893
0500000US17119,"Madison County, Illinois",107413,93995,457,86596,6942,13418
0500000US17131,"Mercer County, Illinois",6624,5727,66,5142,519,897
0500000US17003,"Alexander County, Illinois",2323,1309,16,1099,194,1014
0500000US17157,"Randolph County, Illinois",11873,9784,147,8577,1060,2089
0500000US17115,"Macon County, Illinois",44113,37516,121,33750,3645,6597
0500000US17191,"Wayne County, Illinois",7075,5611,75,4808,728,1464
0500000US17055,"Franklin County, Illinois",16135,12779,130,10890,1759,3356
0500000US17109,"McDonough County, Illinois",11292,9588,69,8336,1183,1704
0500000US17139,"Moultrie County, Illinois",5910,4925,15,4398,512,985
0500000US17151,"Pope County, Illinois",1644,1110,19,983,108,534
0500000US17173,"Shelby County, Illinois",9203,7754,119,6456,1179,1449
0500000US17019,"Champaign County, Illinois",82499,76080,243,67034,8803,6419
0500000US17053,"Ford County, Illinois",5779,4843,43,4479,321,936
0500000US17093,"Kendall County, Illinois",40407,38527,76,36873,1578,1880
0500000US17121,"Marion County, Illinois",15913,13527,96,11903,1528,2386
0500000US17125,"Mason County, Illinois",6027,5031,50,4432,549,996
0500000US18149,"Starke County, Indiana",8735,7271,99,6076,1096,1464
0500000US18055,"Greene County, Indiana",12790,10275,106,8711,1458,2515
0500000US18177,"Wayne County, Indiana",26611,22483,215,18252,4016,4128
0500000US18037,"Dubois County, Indiana",16550,14153,218,12892,1043,2397
0500000US18059,"Hancock County, Indiana",28215,26120,136,23553,2431,2095
0500000US18115,"Ohio County, Indiana",2513,2003,11,1822,170,510
0500000US18121,"Parke County, Indiana",6145,4691,21,4053,617,1454
0500000US18007,"Benton County, Indiana",3403,2999,45,2498,456,404
0500000US18133,"Putnam County, Indiana",13439,11935,125,10331,1479,1504
0500000US18175,"Washington County, Indiana",10721,8378,119,7094,1165,2343
0500000US18065,"Henry County, Indiana",18408,15206,123,12815,2268,3202
0500000US18095,"Madison County, Indiana",51422,43921,213,39331,4377,7501
0500000US18125,"Pike County, Indiana",5129,4083,66,3305,712,1046
0500000US18151,"Steuben County, Indiana",14156,12555,126,11171,1258,1601
0500000US18103,"Miami County, Indiana",13707,11608,66,9827,1715,2099
0500000US18179,"Wells County, Indiana",10874,9334,61,8156,1117,1540
0500000US18035,"Delaware County, Indiana",46028,40274,168,34815,5291,5754
0500000US18077,"Jefferson County, Indiana",12759,10899,55,9589,1255,1860
0500000US18111,"Newton County, Indiana",5562,4966,53,4347,566,596
0500000US18141,"St. Joseph County, Indiana",101241,86306,528,76215,9563,14935
0500000US18155,"Switzerland County, Indiana",4297,3451,93,2877,481,846
0500000US18015,"Carroll County, Indiana",7880,6795,86,5838,871,1085
0500000US18069,"Huntington County, Indiana",14754,12735,116,10972,1647,2019
0500000US18181,"White County, Indiana",9745,8485,64,7409,1012,1260
0500000US18075,"Jay County, Indiana",8149,6626,116,5297,1213,1523
0500000US18019,"Clark County, Indiana",44275,38600,188,32953,5459,5675
0500000US19101,"Jefferson County, Iowa",6831,5893,81,5222,590,938
0500000US19005,"Allamakee County, Iowa",5957,4788,39,4183,566,1169
0500000US19049,"Dallas County, Iowa",32886,31035,124,28891,2020,1851
0500000US19023,"Butler County, Iowa",6251,5117,114,4493,510,1134
0500000US19071,"Fremont County, Iowa",2990,2565,55,2234,276,425
0500000US19173,"Taylor County, Iowa",2650,2167,16,1861,290,483
0500000US19195,"Worth County, Iowa",3170,2614,24,2305,285,556
0500000US19003,"Adams County, Iowa",1641,1363,16,1170,177,278
0500000US19037,"Chickasaw County, Iowa",5191,4305,107,3837,361,886
0500000US19059,"Dickinson County, Iowa",8069,7229,32,6546,651,840
0500000US19103,"Johnson County, Iowa",58163,54913,212,50963,3738,3250
0500000US19171,"Tama County, Iowa",6755,5856,72,4975,809,899
0500000US19069,"Franklin County, Iowa",4200,3261,79,2820,362,939
0500000US19027,"Carroll County, Iowa",8674,7239,72,6585,582,1435
0500000US19067,"Floyd County, Iowa",6759,5499,17,4936,546,1260
0500000US19115,"Louisa County, Iowa",4343,3591,37,3271,283,752
0500000US19119,"Lyon County, Iowa",4549,4034,27,3637,370,515
0500000US19165,"Shelby County, Iowa",5046,4235,46,3773,416,811
0500000US19087,"Henry County, Iowa",7714,6596,68,5704,824,1118
0500000US19145,"Page County, Iowa",6323,5411,80,4759,572,912
0500000US19155,"Pottawattamie County, Iowa",36881,31786,201,28012,3573,5095
0500000US19043,"Clayton County, Iowa",7652,6086,83,5449,554,1566
0500000US19021,"Buena Vista County, Iowa",7550,6642,58,5914,670,908
0500000US19077,"Guthrie County, Iowa",4397,3697,77,3233,387,700
0500000US19091,"Humboldt County, Iowa",4221,3481,30,3147,304,740
0500000US19183,"Washington County, Iowa",8720,7533,97,6573,863,1187
