GEO_ID,NAME,Total,hascomputer,dialup,broadband,nointernet,nocomputer
1400000US26093741601,"Census Tract 7416.01, Livingston County, Michigan",990,836,0,758,78,154
1400000US26093733602,"Census Tract 7336.02, Livingston County, Michigan",1398,1313,0,1202,111,85
1400000US26093741602,"Census Tract 7416.02, Livingston County, Michigan",1456,1384,6,1304,74,72
1400000US26093742201,"Census Tract 7422.01, Livingston County, Michigan",1275,1054,0,1025,29,221
1400000US26093742202,"Census Tract 7422.02, Livingston County, Michigan",980,832,5,727,100,148
1400000US26093742401,"Census Tract 7424.01, Livingston County, Michigan",518,507,0,453,54,11
1400000US26093742402,"Census Tract 7424.02, Livingston County, Michigan",1694,1601,0,1461,140,93
1400000US26095980000,"Census Tract 9800, Luce County, Michigan",0,0,0,0,0,0
1400000US26095990000,"Census Tract 9900, Luce County, Michigan",0,0,0,0,0,0
1400000US26097990000,"Census Tract 9900, Mackinac County, Michigan",0,0,0,0,0,0
1400000US26099220001,"Census Tract 2200.01, Macomb County, Michigan",2764,2699,0,2659,40,65
1400000US26099220002,"Census Tract 2200.02, Macomb County, Michigan",1941,1681,8,1521,152,260
1400000US26099222101,"Census Tract 2221.01, Macomb County, Michigan",2165,1982,7,1818,157,183
1400000US26099222102,"Census Tract 2221.02, Macomb County, Michigan",3398,3064,0,2832,232,334
1400000US26099225701,"Census Tract 2257.01, Macomb County, Michigan",2619,2417,0,2310,107,202
1400000US26099225702,"Census Tract 2257.02, Macomb County, Michigan",735,645,6,578,61,90
1400000US26099230601,"Census Tract 2306.01, Macomb County, Michigan",3029,2766,10,2679,77,263
1400000US26099230602,"Census Tract 2306.02, Macomb County, Michigan",2198,1985,20,1850,115,213
1400000US26099247601,"Census Tract 2476.01, Macomb County, Michigan",1084,963,5,874,84,121
1400000US26163985400,"Census Tract 9854, Wayne County, Michigan",4,4,0,0,4,0
1400000US26163985500,"Census Tract 9855, Wayne County, Michigan",0,0,0,0,0,0
1400000US26163985600,"Census Tract 9856, Wayne County, Michigan",0,0,0,0,0,0
1400000US26163985700,"Census Tract 9857, Wayne County, Michigan",0,0,0,0,0,0
1400000US26163985900,"Census Tract 9859, Wayne County, Michigan",0,0,0,0,0,0
1400000US26163990100,"Census Tract 9901, Wayne County, Michigan",0,0,0,0,0,0
1400000US26163990200,"Census Tract 9902, Wayne County, Michigan",0,0,0,0,0,0
1400000US26165380100,"Census Tract 3801, Wexford County, Michigan",1826,1401,7,1104,290,425
1400000US26165380200,"Census Tract 3802, Wexford County, Michigan",1752,1563,34,1266,263,189
1400000US26165380300,"Census Tract 3803, Wexford County, Michigan",1092,878,30,658,190,214
1400000US26165380400,"Census Tract 3804, Wexford County, Michigan",1891,1643,21,1396,226,248
1400000US26165380500,"Census Tract 3805, Wexford County, Michigan",2583,2156,0,1958,198,427
1400000US26165380600,"Census Tract 3806, Wexford County, Michigan",1178,1020,11,906,103,158
1400000US26165380700,"Census Tract 3807, Wexford County, Michigan",1245,1079,0,826,253,166
1400000US26165380800,"Census Tract 3808, Wexford County, Michigan",1486,1217,0,1033,184,269
1400000US26125160700,"Census Tract 1607, Oakland County, Michigan",617,537,0,505,32,80
1400000US26125161100,"Census Tract 1611, Oakland County, Michigan",2009,1609,0,1443,166,400
1400000US26125161900,"Census Tract 1619, Oakland County, Michigan",890,848,0,740,108,42
1400000US26125166700,"Census Tract 1667, Oakland County, Michigan",837,811,5,739,67,26
1400000US26125168600,"Census Tract 1686, Oakland County, Michigan",2693,2499,15,2366,118,194
1400000US26125170000,"Census Tract 1700, Oakland County, Michigan",1048,1034,0,968,66,14
1400000US26125173100,"Census Tract 1731, Oakland County, Michigan",947,898,5,878,15,49
1400000US26125173400,"Census Tract 1734, Oakland County, Michigan",2618,2493,0,2316,177,125
1400000US26125180300,"Census Tract 1803, Oakland County, Michigan",1468,1247,0,1099,148,221
1400000US26163564600,"Census Tract 5646, Wayne County, Michigan",2274,2249,15,2172,62,25
1400000US26163567000,"Census Tract 5670, Wayne County, Michigan",1261,1091,7,942,142,170
1400000US26163569200,"Census Tract 5692, Wayne County, Michigan",1132,932,0,799,133,200
1400000US26163569100,"Census Tract 5691, Wayne County, Michigan",947,875,0,795,80,72
1400000US26163564800,"Census Tract 5648, Wayne County, Michigan",1712,1658,0,1602,56,54
1400000US26159010400,"Census Tract 104, Van Buren County, Michigan",1062,892,0,767,125,170
1400000US26161403400,"Census Tract 4034, Washtenaw County, Michigan",1386,1266,0,1247,19,120
1400000US26161403800,"Census Tract 4038, Washtenaw County, Michigan",1337,1291,0,1128,163,46
1400000US26049003400,"Census Tract 34, Genesee County, Michigan",780,476,0,254,222,304
1400000US26049010112,"Census Tract 101.12, Genesee County, Michigan",980,918,5,791,122,62
1400000US26049010113,"Census Tract 101.13, Genesee County, Michigan",1087,977,0,915,62,110
1400000US26049010115,"Census Tract 101.15, Genesee County, Michigan",332,291,2,255,34,41
1400000US26049010202,"Census Tract 102.02, Genesee County, Michigan",646,576,4,535,37,70
1400000US26049010700,"Census Tract 107, Genesee County, Michigan",1872,1770,0,1652,118,102
1400000US26049010811,"Census Tract 108.11, Genesee County, Michigan",922,789,0,705,84,133
1400000US26049010812,"Census Tract 108.12, Genesee County, Michigan",1249,991,10,583,398,258
1400000US26049011901,"Census Tract 119.01, Genesee County, Michigan",933,861,9,808,44,72
1400000US26049011301,"Census Tract 113.01, Genesee County, Michigan",2085,1584,0,1142,442,501
1400000US26049011302,"Census Tract 113.02, Genesee County, Michigan",1291,1039,0,1016,23,252
1400000US26049011503,"Census Tract 115.03, Genesee County, Michigan",1816,1565,0,1461,104,251
1400000US26049012100,"Census Tract 121, Genesee County, Michigan",999,864,0,763,101,135
1400000US26049012503,"Census Tract 125.03, Genesee County, Michigan",1160,1012,0,823,189,148
1400000US26049000200,"Census Tract 2, Genesee County, Michigan",656,432,7,292,133,224
1400000US26049000900,"Census Tract 9, Genesee County, Michigan",1032,785,0,548,237,247
1400000US26049010114,"Census Tract 101.14, Genesee County, Michigan",1028,941,9,804,128,87
1400000US26049010502,"Census Tract 105.02, Genesee County, Michigan",1666,1397,7,1152,238,269
1400000US26049011102,"Census Tract 111.02, Genesee County, Michigan",2514,2297,14,2196,87,217
1400000US26049011209,"Census Tract 112.09, Genesee County, Michigan",2748,2603,38,2320,245,145
1400000US26049011508,"Census Tract 115.08, Genesee County, Michigan",1351,1008,0,870,138,343
1400000US26049011711,"Census Tract 117.11, Genesee County, Michigan",1310,1066,0,966,100,244
1400000US26049012601,"Census Tract 126.01, Genesee County, Michigan",1125,1060,0,974,86,65
1400000US26049012603,"Census Tract 126.03, Genesee County, Michigan",1032,891,9,771,111,141
1400000US26049012703,"Census Tract 127.03, Genesee County, Michigan",1195,1096,0,1046,50,99
1400000US26049012906,"Census Tract 129.06, Genesee County, Michigan",985,893,11,826,56,92
1400000US26049010603,"Census Tract 106.03, Genesee County, Michigan",2321,1909,0,1738,171,412
1400000US26049011212,"Census Tract 112.12, Genesee County, Michigan",2272,2061,13,1872,176,211
1400000US26049011213,"Census Tract 112.13, Genesee County, Michigan",1903,1809,0,1774,35,94
1400000US26049011402,"Census Tract 114.02, Genesee County, Michigan",1537,1414,0,1345,69,123
1400000US26049011713,"Census Tract 117.13, Genesee County, Michigan",2074,1775,11,1613,151,299
1400000US26049011714,"Census Tract 117.14, Genesee County, Michigan",1365,1200,0,1164,36,165
1400000US26049011902,"Census Tract 119.02, Genesee County, Michigan",1014,935,0,761,174,79
1400000US26049012401,"Census Tract 124.01, Genesee County, Michigan",683,621,7,569,45,62
1400000US26049012402,"Census Tract 124.02, Genesee County, Michigan",1130,986,2,900,84,144
1400000US26025001100,"Census Tract 11, Calhoun County, Michigan",1834,1597,9,1410,178,237
1400000US26025003100,"Census Tract 31, Calhoun County, Michigan",1145,956,2,832,122,189
1400000US26031960400,"Census Tract 9604, Cheboygan County, Michigan",1695,1556,6,1314,236,139
1400000US26031960800,"Census Tract 9608, Cheboygan County, Michigan",1408,1158,6,971,181,250
1400000US26031960600,"Census Tract 9606, Cheboygan County, Michigan",1175,1022,31,855,136,153
1400000US26031960200,"Census Tract 9602, Cheboygan County, Michigan",1234,1092,22,954,116,142
1400000US26031960300,"Census Tract 9603, Cheboygan County, Michigan",1971,1482,36,1224,222,489
1400000US26031960700,"Census Tract 9607, Cheboygan County, Michigan",1377,1116,14,930,172,261
1400000US26031960100,"Census Tract 9601, Cheboygan County, Michigan",1294,1084,17,895,172,210
1400000US26031960500,"Census Tract 9605, Cheboygan County, Michigan",1047,896,3,803,90,151
1400000US26095960200,"Census Tract 9602, Luce County, Michigan",808,660,12,543,105,148
1400000US26095960100,"Census Tract 9601, Luce County, Michigan",1382,1090,31,971,88,292
1400000US26081012604,"Census Tract 126.04, Kent County, Michigan",2170,2117,0,2039,78,53
1400000US26081012901,"Census Tract 129.01, Kent County, Michigan",1887,1652,0,1396,256,235
1400000US26081013300,"Census Tract 133, Kent County, Michigan",1582,1405,0,1298,107,177
1400000US26081013600,"Census Tract 136, Kent County, Michigan",792,707,10,605,92,85
1400000US26081014501,"Census Tract 145.01, Kent County, Michigan",3898,3744,13,3612,119,154
1400000US26081014701,"Census Tract 147.01, Kent County, Michigan",1500,1248,11,1161,76,252
1400000US26081014704,"Census Tract 147.04, Kent County, Michigan",1036,993,0,917,76,43
1400000US26081014803,"Census Tract 148.03, Kent County, Michigan",1026,989,0,965,24,37
1400000US26081014804,"Census Tract 148.04, Kent County, Michigan",3195,2907,32,2670,205,288
1400000US26081011901,"Census Tract 119.01, Kent County, Michigan",2290,2228,0,2147,81,62
1400000US26081012003,"Census Tract 120.03, Kent County, Michigan",2569,2391,0,2272,119,178
1400000US26081013000,"Census Tract 130, Kent County, Michigan",1357,1194,0,1077,117,163
1400000US26081013500,"Census Tract 135, Kent County, Michigan",1785,1560,0,1388,172,225
1400000US26081000300,"Census Tract 3, Kent County, Michigan",2265,2062,16,1976,70,203
1400000US26081001300,"Census Tract 13, Kent County, Michigan",1248,1041,0,767,274,207
1400000US26081004300,"Census Tract 43, Kent County, Michigan",1595,1511,8,1453,50,84
1400000US26081003000,"Census Tract 30, Kent County, Michigan",661,626,0,583,43,35
1400000US26081003200,"Census Tract 32, Kent County, Michigan",1539,1283,0,1143,140,256
1400000US26081010302,"Census Tract 103.02, Kent County, Michigan",2408,2220,0,2024,196,188
1400000US26081010902,"Census Tract 109.02, Kent County, Michigan",1417,1315,9,1177,129,102
1400000US26081011002,"Census Tract 110.02, Kent County, Michigan",1658,1582,0,1478,104,76
1400000US26081011804,"Census Tract 118.04, Kent County, Michigan",2014,1698,17,1610,71,316
1400000US26037010902,"Census Tract 109.02, Clinton County, Michigan",1626,1474,27,1294,153,152
1400000US26037011001,"Census Tract 110.01, Clinton County, Michigan",1416,1228,34,1076,118,188
1400000US26037010702,"Census Tract 107.02, Clinton County, Michigan",936,804,29,688,87,132
1400000US26037011101,"Census Tract 111.01, Clinton County, Michigan",1767,1581,13,1507,61,186
1400000US26037011002,"Census Tract 110.02, Clinton County, Michigan",1343,1237,18,1192,27,106
1400000US26037010500,"Census Tract 105, Clinton County, Michigan",1308,1164,24,1068,72,144
1400000US26037010701,"Census Tract 107.01, Clinton County, Michigan",799,698,22,610,66,101
1400000US26037010901,"Census Tract 109.01, Clinton County, Michigan",1015,887,30,792,65,128
1400000US26037010201,"Census Tract 102.01, Clinton County, Michigan",1010,879,0,811,68,131
1400000US26043950100,"Census Tract 9501, Dickinson County, Michigan",694,516,5,435,76,178
1400000US26043950700,"Census Tract 9507, Dickinson County, Michigan",1435,1240,0,1194,46,195
1400000US26043950300,"Census Tract 9503, Dickinson County, Michigan",2183,1821,16,1490,315,362
1400000US26099247602,"Census Tract 2476.02, Macomb County, Michigan",2231,1893,0,1810,83,338
1400000US26011990100,"Census Tract 9901, Arenac County, Michigan",0,0,0,0,0,0
1400000US26015010401,"Census Tract 104.01, Barry County, Michigan",1361,1173,28,1077,68,188
1400000US26081010700,"Census Tract 107, Kent County, Michigan",2163,1981,20,1779,182,182
1400000US26081011101,"Census Tract 111.01, Kent County, Michigan",1799,1685,18,1551,116,114
1400000US26081011801,"Census Tract 118.01, Kent County, Michigan",2550,2452,0,2376,76,98
1400000US26081012004,"Census Tract 120.04, Kent County, Michigan",1846,1714,9,1529,176,132
1400000US26081012605,"Census Tract 126.05, Kent County, Michigan",1062,1041,0,943,98,21
1400000US26081012606,"Census Tract 126.06, Kent County, Michigan",2324,2119,0,1959,160,205
1400000US26081012902,"Census Tract 129.02, Kent County, Michigan",2024,1818,0,1665,153,206
1400000US26081013801,"Census Tract 138.01, Kent County, Michigan",660,555,5,501,49,105
1400000US26081014602,"Census Tract 146.02, Kent County, Michigan",3699,3317,0,3074,243,382
1400000US26081014807,"Census Tract 148.07, Kent County, Michigan",2906,2722,27,2574,121,184
1400000US26081000700,"Census Tract 7, Kent County, Michigan",1233,1108,11,1034,63,125
1400000US26081000900,"Census Tract 9, Kent County, Michigan",1206,1026,0,847,179,180
1400000US26081003700,"Census Tract 37, Kent County, Michigan",1337,1200,0,1055,145,137
1400000US26081010102,"Census Tract 101.02, Kent County, Michigan",1038,861,0,713,148,177
1400000US26081010600,"Census Tract 106, Kent County, Michigan",4201,3994,14,3820,160,207
1400000US26017285202,"Census Tract 2852.02, Bay County, Michigan",1485,1404,21,1265,118,81
1400000US26081010801,"Census Tract 108.01, Kent County, Michigan",2836,2736,35,2563,138,100
1400000US26015010402,"Census Tract 104.02, Barry County, Michigan",1828,1685,0,1547,138,143
1400000US26017285201,"Census Tract 2852.01, Bay County, Michigan",2744,2195,16,2036,143,549
1400000US26017286500,"Census Tract 2865, Bay County, Michigan",777,601,0,523,78,176
1400000US26017286600,"Census Tract 2866, Bay County, Michigan",2028,1713,0,1633,80,315
1400000US26017990000,"Census Tract 9900, Bay County, Michigan",0,0,0,0,0,0
1400000US26019000100,"Census Tract 1, Benzie County, Michigan",2736,2386,14,2254,118,350
1400000US26019000200,"Census Tract 2, Benzie County, Michigan",1234,1150,7,1007,136,84
1400000US26019000300,"Census Tract 3, Benzie County, Michigan",819,752,18,671,63,67
1400000US26019000400,"Census Tract 4, Benzie County, Michigan",849,709,3,655,51,140
1400000US26019000500,"Census Tract 5, Benzie County, Michigan",1095,936,19,781,136,159
1400000US26019990000,"Census Tract 9900, Benzie County, Michigan",0,0,0,0,0,0
1400000US26021990000,"Census Tract 9900, Berrien County, Michigan",0,0,0,0,0,0
1400000US26023951300,"Census Tract 9513, Branch County, Michigan",1538,1388,0,1208,180,150
1400000US26023951400,"Census Tract 9514, Branch County, Michigan",1481,1286,9,1102,175,195
1400000US26023951500,"Census Tract 9515, Branch County, Michigan",1153,1086,0,958,128,67
1400000US26023951600,"Census Tract 9516, Branch County, Michigan",1470,1134,11,1056,67,336
1400000US26025004100,"Census Tract 41, Calhoun County, Michigan",831,688,0,577,111,143
1400000US26027001600,"Census Tract 16, Cass County, Michigan",1422,1241,0,1008,233,181
1400000US26027001700,"Census Tract 17, Cass County, Michigan",2112,1786,15,1431,340,326
1400000US26027001800,"Census Tract 18, Cass County, Michigan",3079,2846,18,2553,275,233
1400000US26027001900,"Census Tract 19, Cass County, Michigan",2091,1865,27,1637,201,226
1400000US26027002000,"Census Tract 20, Cass County, Michigan",1738,1465,8,1287,170,273
1400000US26027002100,"Census Tract 21, Cass County, Michigan",2307,1928,9,1626,293,379
1400000US26027002200,"Census Tract 22, Cass County, Michigan",2568,2284,38,1771,475,284
1400000US26029000100,"Census Tract 1, Charlevoix County, Michigan",738,650,11,537,102,88
1400000US26029000200,"Census Tract 2, Charlevoix County, Michigan",583,506,0,474,32,77
1400000US26029000300,"Census Tract 3, Charlevoix County, Michigan",1017,898,11,797,90,119
1400000US26029000400,"Census Tract 4, Charlevoix County, Michigan",1116,1039,0,952,87,77
1400000US26029000500,"Census Tract 5, Charlevoix County, Michigan",272,245,4,221,20,27
1400000US26029000800,"Census Tract 8, Charlevoix County, Michigan",1208,1071,11,872,188,137
1400000US26029000900,"Census Tract 9, Charlevoix County, Michigan",838,764,0,692,72,74
1400000US26043950200,"Census Tract 9502, Dickinson County, Michigan",1811,1611,20,1460,131,200
1400000US26043950500,"Census Tract 9505, Dickinson County, Michigan",1132,987,19,891,77,145
1400000US26043950600,"Census Tract 9506, Dickinson County, Michigan",2006,1667,25,1484,158,339
1400000US26043950400,"Census Tract 9504, Dickinson County, Michigan",1826,1408,0,1148,260,418
1400000US26063950100,"Census Tract 9501, Huron County, Michigan",680,570,5,486,79,110
1400000US26063950700,"Census Tract 9507, Huron County, Michigan",1595,1317,13,1083,221,278
1400000US26063951100,"Census Tract 9511, Huron County, Michigan",827,717,3,602,112,110
1400000US26063951200,"Census Tract 9512, Huron County, Michigan",1733,1343,3,1174,166,390
1400000US26063950300,"Census Tract 9503, Huron County, Michigan",971,796,4,699,93,175
1400000US26063950200,"Census Tract 9502, Huron County, Michigan",922,754,4,667,83,168
1400000US26063950600,"Census Tract 9506, Huron County, Michigan",1117,948,4,765,179,169
1400000US26063950500,"Census Tract 9505, Huron County, Michigan",1066,892,8,746,138,174
1400000US26081011302,"Census Tract 113.02, Kent County, Michigan",2807,2714,16,2610,88,93
1400000US26063950800,"Census Tract 9508, Huron County, Michigan",1438,1214,0,984,230,224
1400000US26081010904,"Census Tract 109.04, Kent County, Michigan",2464,2412,0,2319,93,52
1400000US26081011200,"Census Tract 112, Kent County, Michigan",1762,1540,0,1400,140,222
1400000US26081011403,"Census Tract 114.03, Kent County, Michigan",1058,952,0,892,60,106
1400000US26081011702,"Census Tract 117.02, Kent County, Michigan",1788,1672,16,1512,144,116
1400000US26081011803,"Census Tract 118.03, Kent County, Michigan",1477,1391,8,1351,32,86
1400000US26081000200,"Census Tract 2, Kent County, Michigan",661,600,0,567,33,61
1400000US26081000600,"Census Tract 6, Kent County, Michigan",1741,1500,0,1466,34,241
1400000US26081001101,"Census Tract 11.01, Kent County, Michigan",2145,1816,25,1592,199,329
1400000US26081001900,"Census Tract 19, Kent County, Michigan",1864,1690,0,1508,182,174
1400000US26081003500,"Census Tract 35, Kent County, Michigan",2007,1650,0,1534,116,357
1400000US26081003600,"Census Tract 36, Kent County, Michigan",740,524,0,416,108,216
1400000US26081003900,"Census Tract 39, Kent County, Michigan",885,708,0,616,92,177
1400000US26081004600,"Census Tract 46, Kent County, Michigan",2193,1889,15,1541,333,304
1400000US26081010802,"Census Tract 108.02, Kent County, Michigan",2229,2119,64,1897,158,110
1400000US26081012500,"Census Tract 125, Kent County, Michigan",1688,1606,0,1561,45,82
1400000US26081013802,"Census Tract 138.02, Kent County, Michigan",2924,2565,0,2354,211,359
1400000US26081014502,"Census Tract 145.02, Kent County, Michigan",3042,2837,0,2710,127,205
1400000US26081014805,"Census Tract 148.05, Kent County, Michigan",2578,2471,0,2421,50,107
1400000US26155031900,"Census Tract 319, Shiawassee County, Michigan",1665,1468,0,1310,158,197
1400000US26017280600,"Census Tract 2806, Bay County, Michigan",1047,933,0,798,135,114
1400000US26017281300,"Census Tract 2813, Bay County, Michigan",1267,1092,0,1022,70,175
1400000US26017285700,"Census Tract 2857, Bay County, Michigan",1602,1409,0,1274,135,193
1400000US26017286400,"Census Tract 2864, Bay County, Michigan",973,751,10,636,105,222
1400000US26017280300,"Census Tract 2803, Bay County, Michigan",600,507,0,434,73,93
1400000US26017285400,"Census Tract 2854, Bay County, Michigan",1450,1237,21,1195,21,213
1400000US26017286300,"Census Tract 2863, Bay County, Michigan",1517,1285,12,1119,154,232
1400000US26017280800,"Census Tract 2808, Bay County, Michigan",1450,1215,8,1062,145,235
1400000US26017286000,"Census Tract 2860, Bay County, Michigan",1214,1070,0,1027,43,144
1400000US26017286200,"Census Tract 2862, Bay County, Michigan",2261,1905,6,1720,179,356
1400000US26017280700,"Census Tract 2807, Bay County, Michigan",1371,1053,0,986,67,318
1400000US26017285800,"Census Tract 2858, Bay County, Michigan",2618,2133,22,2009,102,485
1400000US26017285900,"Census Tract 2859, Bay County, Michigan",2241,1985,17,1684,284,256
1400000US26017285100,"Census Tract 2851, Bay County, Michigan",1366,1156,0,1091,65,210
1400000US26017285300,"Census Tract 2853, Bay County, Michigan",1866,1514,19,1366,129,352
1400000US26017285500,"Census Tract 2855, Bay County, Michigan",2831,2440,0,2309,131,391
1400000US26017280400,"Census Tract 2804, Bay County, Michigan",1173,916,14,798,104,257
1400000US26017285600,"Census Tract 2856, Bay County, Michigan",2828,2563,19,2411,133,265
1400000US26017280900,"Census Tract 2809, Bay County, Michigan",1145,882,0,822,60,263
1400000US26017286100,"Census Tract 2861, Bay County, Michigan",3015,2608,24,2393,191,407
1400000US26017280500,"Census Tract 2805, Bay County, Michigan",1430,1343,0,1228,115,87
1400000US26017281000,"Census Tract 2810, Bay County, Michigan",1592,1414,7,1250,157,178
1400000US26081004500,"Census Tract 45, Kent County, Michigan",3162,2788,16,2548,224,374
1400000US26081003100,"Census Tract 31, Kent County, Michigan",1029,848,7,725,116,181
1400000US26081003800,"Census Tract 38, Kent County, Michigan",1122,925,0,832,93,197
1400000US26081004200,"Census Tract 42, Kent County, Michigan",1684,1526,0,1450,76,158
1400000US26161410700,"Census Tract 4107, Washtenaw County, Michigan",719,464,0,408,56,255
1400000US26161404300,"Census Tract 4043, Washtenaw County, Michigan",1133,1077,8,1034,35,56
1400000US26161404500,"Census Tract 4045, Washtenaw County, Michigan",2316,2064,0,2010,54,252
1400000US26161410500,"Census Tract 4105, Washtenaw County, Michigan",1219,1130,8,983,139,89
1400000US26161411100,"Census Tract 4111, Washtenaw County, Michigan",77,69,0,24,45,8
1400000US26161411700,"Census Tract 4117, Washtenaw County, Michigan",902,848,9,774,65,54
1400000US26161412300,"Census Tract 4123, Washtenaw County, Michigan",1046,926,12,856,58,120
1400000US26161413000,"Census Tract 4130, Washtenaw County, Michigan",1528,1433,0,1326,107,95
1400000US26161416000,"Census Tract 4160, Washtenaw County, Michigan",1140,1117,0,1085,32,23
1400000US26161416200,"Census Tract 4162, Washtenaw County, Michigan",1714,1632,7,1550,75,82
1400000US26161421900,"Census Tract 4219, Washtenaw County, Michigan",10,10,0,10,0,0
1400000US26161454000,"Census Tract 4540, Washtenaw County, Michigan",1993,1812,0,1648,164,181
1400000US26161402500,"Census Tract 4025, Washtenaw County, Michigan",1167,1136,0,1029,107,31
1400000US26161403100,"Census Tract 4031, Washtenaw County, Michigan",597,569,5,552,12,28
1400000US26161403600,"Census Tract 4036, Washtenaw County, Michigan",2413,2333,0,2221,112,80
1400000US26161404600,"Census Tract 4046, Washtenaw County, Michigan",2413,2354,0,2316,38,59
1400000US26161410300,"Census Tract 4103, Washtenaw County, Michigan",1774,1712,0,1546,166,62
1400000US26161410800,"Census Tract 4108, Washtenaw County, Michigan",730,624,4,572,48,106
1400000US26161414900,"Census Tract 4149, Washtenaw County, Michigan",1199,1191,0,1150,41,8
1400000US26161455000,"Census Tract 4550, Washtenaw County, Michigan",1791,1717,10,1676,31,74
1400000US26161400800,"Census Tract 4008, Washtenaw County, Michigan",1194,1185,0,1107,78,9
1400000US26161402200,"Census Tract 4022, Washtenaw County, Michigan",1336,1320,7,832,481,16
1400000US26161400100,"Census Tract 4001, Washtenaw County, Michigan",1377,1327,0,1146,181,50
1400000US26161400400,"Census Tract 4004, Washtenaw County, Michigan",1172,1136,0,1107,29,36
1400000US26161400700,"Census Tract 4007, Washtenaw County, Michigan",1290,1149,11,1099,39,141
1400000US26161402100,"Census Tract 4021, Washtenaw County, Michigan",1564,1483,8,1410,65,81
1400000US26161403500,"Census Tract 4035, Washtenaw County, Michigan",1377,1296,8,1266,22,81
1400000US26161405300,"Census Tract 4053, Washtenaw County, Michigan",2037,2037,0,2006,31,0
1400000US26161405400,"Census Tract 4054, Washtenaw County, Michigan",1010,946,0,917,29,64
1400000US26161405500,"Census Tract 4055, Washtenaw County, Michigan",1055,936,0,903,33,119
1400000US26161405600,"Census Tract 4056, Washtenaw County, Michigan",1849,1698,0,1587,111,151
1400000US26161410200,"Census Tract 4102, Washtenaw County, Michigan",1124,1084,0,956,128,40
1400000US26161412100,"Census Tract 4121, Washtenaw County, Michigan",1502,1283,8,1022,253,219
1400000US26161412700,"Census Tract 4127, Washtenaw County, Michigan",2072,1956,0,1857,99,116
1400000US26161413200,"Census Tract 4132, Washtenaw County, Michigan",1566,1469,0,1449,20,97
1400000US26161415200,"Census Tract 4152, Washtenaw County, Michigan",1084,1080,0,1055,25,4
1400000US26161415800,"Census Tract 4158, Washtenaw County, Michigan",1261,1253,0,1244,9,8
1400000US26049012702,"Census Tract 127.02, Genesee County, Michigan",2451,2126,10,1953,163,325
1400000US26049012905,"Census Tract 129.05, Genesee County, Michigan",1616,1418,7,1290,121,198
1400000US26049012907,"Census Tract 129.07, Genesee County, Michigan",830,787,6,748,33,43
1400000US26049003500,"Census Tract 35, Genesee County, Michigan",1404,928,0,870,58,476
1400000US26049000100,"Census Tract 1, Genesee County, Michigan",1048,724,0,525,199,324
1400000US26049010201,"Census Tract 102.01, Genesee County, Michigan",660,622,5,573,44,38
1400000US26049011502,"Census Tract 115.02, Genesee County, Michigan",1309,1121,0,1042,79,188
1400000US26081011001,"Census Tract 110.01, Kent County, Michigan",1484,1411,0,1342,69,73
1400000US26081012203,"Census Tract 122.03, Kent County, Michigan",1956,1729,21,1637,71,227
1400000US26081011102,"Census Tract 111.02, Kent County, Michigan",1810,1659,23,1532,104,151
1400000US26081011701,"Census Tract 117.01, Kent County, Michigan",2192,2003,20,1889,94,189
1400000US26081012002,"Census Tract 120.02, Kent County, Michigan",2369,2177,7,1949,221,192
1400000US26081012701,"Census Tract 127.01, Kent County, Michigan",2757,2461,0,2132,329,296
1400000US26163579900,"Census Tract 5799, Wayne County, Michigan",1822,1700,0,1459,241,122
1400000US26163591501,"Census Tract 5915.01, Wayne County, Michigan",1240,995,9,814,172,245
1400000US26163591502,"Census Tract 5915.02, Wayne County, Michigan",1224,1062,8,989,65,162
1400000US26163985000,"Census Tract 9850, Wayne County, Michigan",0,0,0,0,0,0
1400000US26163985100,"Census Tract 9851, Wayne County, Michigan",125,116,0,101,15,9
1400000US26163985200,"Census Tract 9852, Wayne County, Michigan",0,0,0,0,0,0
1400000US26163985300,"Census Tract 9853, Wayne County, Michigan",159,159,0,133,26,0
1400000US26163536500,"Census Tract 5365, Wayne County, Michigan",938,754,0,435,319,184
1400000US26163537000,"Census Tract 5370, Wayne County, Michigan",1231,952,17,640,295,279
1400000US26163537300,"Census Tract 5373, Wayne County, Michigan",720,609,0,333,276,111
1400000US26163537500,"Census Tract 5375, Wayne County, Michigan",940,806,26,538,242,134
1400000US26163538600,"Census Tract 5386, Wayne County, Michigan",2023,1728,0,1436,292,295
1400000US26163538700,"Census Tract 5387, Wayne County, Michigan",1554,1253,33,995,225,301
1400000US26163538800,"Census Tract 5388, Wayne County, Michigan",717,611,0,528,83,106
1400000US26151970500,"Census Tract 9705, Sanilac County, Michigan",1087,921,22,797,102,166
1400000US26151970600,"Census Tract 9706, Sanilac County, Michigan",1096,934,25,761,148,162
1400000US26151971000,"Census Tract 9710, Sanilac County, Michigan",1714,1462,7,1168,287,252
1400000US26151970100,"Census Tract 9701, Sanilac County, Michigan",743,625,10,528,87,118
1400000US26151970300,"Census Tract 9703, Sanilac County, Michigan",1346,1068,14,823,231,278
1400000US26151971100,"Census Tract 9711, Sanilac County, Michigan",1383,1100,10,928,162,283
1400000US26151970400,"Census Tract 9704, Sanilac County, Michigan",1573,1321,16,1103,202,252
1400000US26151970800,"Census Tract 9708, Sanilac County, Michigan",2399,1955,15,1738,202,444
1400000US26151970900,"Census Tract 9709, Sanilac County, Michigan",2012,1635,16,1337,282,377
1400000US26151970700,"Census Tract 9707, Sanilac County, Michigan",837,700,12,592,96,137
1400000US26151971200,"Census Tract 9712, Sanilac County, Michigan",2022,1695,38,1394,263,327
1400000US26151970200,"Census Tract 9702, Sanilac County, Michigan",967,742,10,570,162,225
1400000US26131970100,"Census Tract 9701, Ontonagon County, Michigan",811,569,7,466,96,242
1400000US26131970300,"Census Tract 9703, Ontonagon County, Michigan",835,695,17,572,106,140
1400000US26131970200,"Census Tract 9702, Ontonagon County, Michigan",1230,982,16,799,167,248
1400000US26125197000,"Census Tract 1970, Oakland County, Michigan",1577,1548,0,1511,37,29
1400000US26125198000,"Census Tract 1980, Oakland County, Michigan",1269,1269,6,1219,44,0
1400000US26125132700,"Census Tract 1327, Oakland County, Michigan",1183,1136,0,1075,61,47
1400000US26125137800,"Census Tract 1378, Oakland County, Michigan",1403,1375,0,1292,83,28
1400000US26125123100,"Census Tract 1231, Oakland County, Michigan",1067,1060,0,1043,17,7
1400000US26125127300,"Census Tract 1273, Oakland County, Michigan",2013,1827,17,1679,131,186
1400000US26125127500,"Census Tract 1275, Oakland County, Michigan",2509,2371,0,2300,71,138
1400000US26125128800,"Census Tract 1288, Oakland County, Michigan",500,443,0,443,0,57
1400000US26125131300,"Census Tract 1313, Oakland County, Michigan",1998,1866,8,1728,130,132
1400000US26125132600,"Census Tract 1326, Oakland County, Michigan",1471,1439,12,1408,19,32
1400000US26049012504,"Census Tract 125.04, Genesee County, Michigan",750,715,6,661,48,35
1400000US26049000600,"Census Tract 6, Genesee County, Michigan",644,497,0,309,188,147
1400000US26049012602,"Census Tract 126.02, Genesee County, Michigan",626,510,0,440,70,116
1400000US26049003000,"Census Tract 30, Genesee County, Michigan",1712,1397,0,1304,93,315
1400000US26049010910,"Census Tract 109.10, Genesee County, Michigan",1378,1103,0,1014,89,275
1400000US26049012003,"Census Tract 120.03, Genesee County, Michigan",1079,928,0,842,86,151
1400000US26049001400,"Census Tract 14, Genesee County, Michigan",517,321,8,242,71,196
1400000US26049010911,"Census Tract 109.11, Genesee County, Michigan",1767,1383,0,1140,243,384
1400000US26049011712,"Census Tract 117.12, Genesee County, Michigan",1221,992,0,855,137,229
1400000US26049013002,"Census Tract 130.02, Genesee County, Michigan",1493,1333,0,1241,92,160
1400000US26049004000,"Census Tract 40, Genesee County, Michigan",1571,1055,0,862,193,516
1400000US26009960200,"Census Tract 9602, Antrim County, Michigan",1307,1124,9,887,228,183
1400000US26009960500,"Census Tract 9605, Antrim County, Michigan",1402,1247,11,1115,121,155
1400000US26009960300,"Census Tract 9603, Antrim County, Michigan",1244,1145,2,1029,114,99
1400000US26075006701,"Census Tract 67.01, Jackson County, Michigan",1906,1696,16,1511,169,210
1400000US26075005100,"Census Tract 51, Jackson County, Michigan",1759,1487,7,1368,112,272
1400000US26075006100,"Census Tract 61, Jackson County, Michigan",2829,2440,0,2178,262,389
1400000US26075006402,"Census Tract 64.02, Jackson County, Michigan",2700,2389,64,2160,165,311
1400000US26075006500,"Census Tract 65, Jackson County, Michigan",2520,2179,10,1971,198,341
1400000US26075006600,"Census Tract 66, Jackson County, Michigan",1952,1650,11,1344,295,302
1400000US26075006801,"Census Tract 68.01, Jackson County, Michigan",1308,1109,27,924,158,199
1400000US26075006401,"Census Tract 64.01, Jackson County, Michigan",1105,997,4,897,96,108
1400000US26075006000,"Census Tract 60, Jackson County, Michigan",2907,2453,0,2234,219,454
1400000US26075000400,"Census Tract 4, Jackson County, Michigan",1487,1353,0,1112,241,134
1400000US26075006200,"Census Tract 62, Jackson County, Michigan",2913,2526,0,2363,163,387
1400000US26075000200,"Census Tract 2, Jackson County, Michigan",1106,941,0,610,331,165
1400000US26075005200,"Census Tract 52, Jackson County, Michigan",2497,2348,17,2126,205,149
1400000US26075005900,"Census Tract 59, Jackson County, Michigan",1054,836,0,639,197,218
1400000US26075005500,"Census Tract 55, Jackson County, Michigan",2528,2063,0,1583,480,465
1400000US26075000500,"Census Tract 5, Jackson County, Michigan",723,641,0,560,81,82
1400000US26097950300,"Census Tract 9503, Mackinac County, Michigan",872,730,26,587,117,142
1400000US26097950500,"Census Tract 9505, Mackinac County, Michigan",1257,1039,0,956,83,218
1400000US26097950200,"Census Tract 9502, Mackinac County, Michigan",1082,836,19,646,171,246
1400000US26097950400,"Census Tract 9504, Mackinac County, Michigan",1310,1142,11,927,204,168
1400000US26097950100,"Census Tract 9501, Mackinac County, Michigan",763,669,5,570,94,94
1400000US26141950100,"Census Tract 9501, Presque Isle County, Michigan",895,723,18,625,80,172
1400000US26141950200,"Census Tract 9502, Presque Isle County, Michigan",1127,926,28,782,116,201
1400000US26141950400,"Census Tract 9504, Presque Isle County, Michigan",1036,812,11,656,145,224
1400000US26141950600,"Census Tract 9506, Presque Isle County, Michigan",677,611,13,479,119,66
1400000US26141950300,"Census Tract 9503, Presque Isle County, Michigan",879,689,25,569,95,190
1400000US26141950500,"Census Tract 9505, Presque Isle County, Michigan",1194,906,21,777,108,288
1400000US26077001300,"Census Tract 13, Kalamazoo County, Michigan",809,746,0,677,69,63
1400000US26077001701,"Census Tract 17.01, Kalamazoo County, Michigan",1662,1554,9,1362,183,108
1400000US26077001801,"Census Tract 18.01, Kalamazoo County, Michigan",1441,1238,8,1162,68,203
1400000US26077002904,"Census Tract 29.04, Kalamazoo County, Michigan",3787,3601,0,3294,307,186
1400000US26125134000,"Census Tract 1340, Oakland County, Michigan",1889,1784,15,1718,51,105
1400000US26125139200,"Census Tract 1392, Oakland County, Michigan",3013,2663,0,2556,107,350
1400000US26125136300,"Census Tract 1363, Oakland County, Michigan",1941,1873,0,1805,68,68
1400000US26125136700,"Census Tract 1367, Oakland County, Michigan",2284,2215,0,2164,51,69
1400000US26125137100,"Census Tract 1371, Oakland County, Michigan",3425,3364,0,3164,200,61
1400000US26125140500,"Census Tract 1405, Oakland County, Michigan",1072,990,0,920,70,82
1400000US26125140800,"Census Tract 1408, Oakland County, Michigan",2033,1902,0,1838,64,131
1400000US26125141200,"Census Tract 1412, Oakland County, Michigan",1451,1101,0,998,103,350
1400000US26125141400,"Census Tract 1414, Oakland County, Michigan",1609,1372,8,1278,86,237
1400000US26125150200,"Census Tract 1502, Oakland County, Michigan",953,947,0,908,39,6
1400000US26125154200,"Census Tract 1542, Oakland County, Michigan",1641,1494,0,1421,73,147
1400000US26125157200,"Census Tract 1572, Oakland County, Michigan",1340,1272,0,1161,111,68
1400000US26125157400,"Census Tract 1574, Oakland County, Michigan",840,769,0,742,27,71
1400000US26125157700,"Census Tract 1577, Oakland County, Michigan",733,719,0,706,13,14
1400000US26125166200,"Census Tract 1662, Oakland County, Michigan",1015,1015,0,984,31,0
1400000US26163526200,"Census Tract 5262, Wayne County, Michigan",801,650,6,473,171,151
1400000US26163530500,"Census Tract 5305, Wayne County, Michigan",801,610,16,474,120,191
1400000US26163531100,"Census Tract 5311, Wayne County, Michigan",534,269,0,126,143,265
1400000US26163531200,"Census Tract 5312, Wayne County, Michigan",746,667,5,505,157,79
1400000US26163531600,"Census Tract 5316, Wayne County, Michigan",763,555,0,345,210,208
1400000US26163533300,"Census Tract 5333, Wayne County, Michigan",409,268,0,151,117,141
1400000US26163534200,"Census Tract 5342, Wayne County, Michigan",1154,875,27,673,175,279
1400000US26163535200,"Census Tract 5352, Wayne County, Michigan",802,499,0,333,166,303
1400000US26163536600,"Census Tract 5366, Wayne County, Michigan",879,636,0,420,216,243
1400000US26163536900,"Census Tract 5369, Wayne County, Michigan",1102,891,0,603,288,211
1400000US26163537200,"Census Tract 5372, Wayne County, Michigan",243,200,0,117,83,43
1400000US26163539600,"Census Tract 5396, Wayne County, Michigan",1195,1068,0,893,175,127
1400000US26163542100,"Census Tract 5421, Wayne County, Michigan",1642,1411,0,956,455,231
1400000US26163542300,"Census Tract 5423, Wayne County, Michigan",829,684,8,472,204,145
1400000US26163544000,"Census Tract 5440, Wayne County, Michigan",1131,887,4,815,68,244
1400000US26163544300,"Census Tract 5443, Wayne County, Michigan",1171,932,13,719,200,239
1400000US26163545500,"Census Tract 5455, Wayne County, Michigan",1467,1182,0,697,485,285
1400000US26163512100,"Census Tract 5121, Wayne County, Michigan",1067,887,5,509,373,180
1400000US26163512300,"Census Tract 5123, Wayne County, Michigan",539,347,0,255,92,192
1400000US26163535000,"Census Tract 5350, Wayne County, Michigan",982,784,0,501,283,198
1400000US26163525600,"Census Tract 5256, Wayne County, Michigan",420,281,0,249,32,139
1400000US26163526000,"Census Tract 5260, Wayne County, Michigan",994,701,0,648,53,293
1400000US26163533100,"Census Tract 5331, Wayne County, Michigan",654,436,5,259,172,218
1400000US26163533400,"Census Tract 5334, Wayne County, Michigan",865,699,0,434,265,166
1400000US26163535400,"Census Tract 5354, Wayne County, Michigan",619,497,0,295,202,122
1400000US26163552400,"Census Tract 5524, Wayne County, Michigan",703,593,0,488,105,110
1400000US26163546800,"Census Tract 5468, Wayne County, Michigan",1376,1241,0,783,458,135
1400000US26163550900,"Census Tract 5509, Wayne County, Michigan",1124,1058,0,999,59,66
1400000US26163551600,"Census Tract 5516, Wayne County, Michigan",1284,1187,0,1107,80,97
1400000US26099221100,"Census Tract 2211, Macomb County, Michigan",2535,2379,0,2265,114,156
1400000US26077000500,"Census Tract 5, Kalamazoo County, Michigan",1579,1483,0,1379,104,96
1400000US26077000900,"Census Tract 9, Kalamazoo County, Michigan",361,296,0,223,73,65
1400000US26077001802,"Census Tract 18.02, Kalamazoo County, Michigan",2049,1960,0,1760,200,89
1400000US26077001906,"Census Tract 19.06, Kalamazoo County, Michigan",2352,2156,0,2014,142,196
1400000US26077003002,"Census Tract 30.02, Kalamazoo County, Michigan",815,786,5,742,39,29
1400000US26077001504,"Census Tract 15.04, Kalamazoo County, Michigan",272,255,0,150,105,17
1400000US26067031200,"Census Tract 312, Ionia County, Michigan",1965,1693,0,1528,165,272
1400000US26067031500,"Census Tract 315, Ionia County, Michigan",2072,1953,8,1768,177,119
1400000US26067031300,"Census Tract 313, Ionia County, Michigan",3153,2839,59,2434,346,314
1400000US26067030200,"Census Tract 302, Ionia County, Michigan",1027,965,6,891,68,62
1400000US26079950200,"Census Tract 9502, Kalkaska County, Michigan",1973,1767,35,1477,255,206
1400000US26079950300,"Census Tract 9503, Kalkaska County, Michigan",1973,1625,17,1319,289,348
1400000US26079950400,"Census Tract 9504, Kalkaska County, Michigan",1515,1243,47,1010,186,272
1400000US26025003700,"Census Tract 37, Calhoun County, Michigan",1797,1521,22,1257,242,276
1400000US26161444000,"Census Tract 4440, Washtenaw County, Michigan",2250,2169,0,1980,189,81
1400000US26161448000,"Census Tract 4480, Washtenaw County, Michigan",1428,1402,17,1287,98,26
1400000US26161461000,"Census Tract 4610, Washtenaw County, Michigan",2628,2498,0,2423,75,130
1400000US26161464000,"Census Tract 4640, Washtenaw County, Michigan",2076,1948,16,1830,102,128
1400000US26161465000,"Census Tract 4650, Washtenaw County, Michigan",2351,2184,11,1961,212,167
1400000US26161466000,"Census Tract 4660, Washtenaw County, Michigan",937,864,5,796,63,73
1400000US26161404100,"Census Tract 4041, Washtenaw County, Michigan",1372,1307,16,1207,84,65
1400000US26161425000,"Census Tract 4250, Washtenaw County, Michigan",1570,1530,7,1487,36,40
1400000US26161402300,"Census Tract 4023, Washtenaw County, Michigan",1076,1046,8,1014,24,30
1400000US26161407400,"Census Tract 4074, Washtenaw County, Michigan",2267,2101,0,1836,265,166
1400000US26161447000,"Census Tract 4470, Washtenaw County, Michigan",1164,1107,0,1014,93,57
1400000US26161411200,"Census Tract 4112, Washtenaw County, Michigan",1084,1039,0,798,241,45
1400000US26161405100,"Census Tract 4051, Washtenaw County, Michigan",970,892,0,854,38,78
1400000US26161403300,"Census Tract 4033, Washtenaw County, Michigan",1711,1597,0,1575,22,114
1400000US26161407000,"Census Tract 4070, Washtenaw County, Michigan",1825,1752,10,1682,60,73
1400000US26161414300,"Census Tract 4143, Washtenaw County, Michigan",1539,1361,8,1147,206,178
1400000US26161422900,"Census Tract 4229, Washtenaw County, Michigan",0,0,0,0,0,0
1400000US26161421100,"Census Tract 4211, Washtenaw County, Michigan",1393,1255,0,1218,37,138
1400000US26011970200,"Census Tract 9702, Arenac County, Michigan",1353,1057,8,841,208,296
1400000US26011970500,"Census Tract 9705, Arenac County, Michigan",1790,1405,16,1180,209,385
1400000US26011970400,"Census Tract 9704, Arenac County, Michigan",1368,1087,27,937,123,281
1400000US26011970100,"Census Tract 9701, Arenac County, Michigan",1042,793,16,655,122,249
1400000US26011970300,"Census Tract 9703, Arenac County, Michigan",1131,890,9,738,143,241
1400000US26015011400,"Census Tract 114, Barry County, Michigan",2544,2256,18,1994,244,288
1400000US26015010100,"Census Tract 101, Barry County, Michigan",2403,2062,11,1846,205,341
1400000US26015010800,"Census Tract 108, Barry County, Michigan",1336,1156,13,936,207,180
1400000US26015010500,"Census Tract 105, Barry County, Michigan",1326,1266,38,1059,169,60
1400000US26015010700,"Census Tract 107, Barry County, Michigan",2089,1692,33,1430,229,397
1400000US26015010200,"Census Tract 102, Barry County, Michigan",2052,1819,43,1569,207,233
1400000US26015010300,"Census Tract 103, Barry County, Michigan",2866,2536,35,2380,121,330
1400000US26015010600,"Census Tract 106, Barry County, Michigan",3011,2548,38,2162,348,463
1400000US26099221200,"Census Tract 2212, Macomb County, Michigan",2499,2332,0,2224,108,167
1400000US26099222800,"Census Tract 2228, Macomb County, Michigan",1216,1157,0,1116,41,59
1400000US26099224500,"Census Tract 2245, Macomb County, Michigan",1688,1596,0,1492,104,92
1400000US26099258900,"Census Tract 2589, Macomb County, Michigan",1037,897,0,793,104,140
1400000US26099225400,"Census Tract 2254, Macomb County, Michigan",2862,2734,29,2577,128,128
1400000US26099225500,"Census Tract 2255, Macomb County, Michigan",2103,1993,9,1852,132,110
1400000US26099226100,"Census Tract 2261, Macomb County, Michigan",2548,2495,0,2340,155,53
1400000US26099260800,"Census Tract 2608, Macomb County, Michigan",960,810,6,776,28,150
1400000US26099261000,"Census Tract 2610, Macomb County, Michigan",1474,1176,0,1087,89,298
1400000US26099217000,"Census Tract 2170, Macomb County, Michigan",1032,937,20,832,85,95
1400000US26013000100,"Census Tract 1, Baraga County, Michigan",1709,1405,39,1243,123,304
1400000US26013000200,"Census Tract 2, Baraga County, Michigan",1327,1019,15,894,110,308
1400000US26013990100,"Census Tract 9901, Baraga County, Michigan",0,0,0,0,0,0
1400000US26073000700,"Census Tract 7, Isabella County, Michigan",2101,1994,0,956,1038,107
1400000US26073000800,"Census Tract 8, Isabella County, Michigan",1030,1021,0,588,433,9
1400000US26073000900,"Census Tract 9, Isabella County, Michigan",1627,1426,3,1224,199,201
1400000US26073940100,"Census Tract 9401, Isabella County, Michigan",1638,1421,5,1185,231,217
1400000US26073940200,"Census Tract 9402, Isabella County, Michigan",2125,1851,13,1576,262,274
1400000US26073940300,"Census Tract 9403, Isabella County, Michigan",2337,2096,11,1864,221,241
1400000US26073940400,"Census Tract 9404, Isabella County, Michigan",1519,1311,0,1185,126,208
1400000US26073940500,"Census Tract 9405, Isabella County, Michigan",1160,1052,0,974,78,108
1400000US26073940600,"Census Tract 9406, Isabella County, Michigan",1984,1841,13,1652,176,143
1400000US26075006303,"Census Tract 63.03, Jackson County, Michigan",1829,1643,10,1503,130,186
1400000US26075006304,"Census Tract 63.04, Jackson County, Michigan",1200,1098,6,996,96,102
1400000US26075006803,"Census Tract 68.03, Jackson County, Michigan",1219,1102,11,967,124,117
1400000US26075006804,"Census Tract 68.04, Jackson County, Michigan",2176,2088,51,1912,125,88
1400000US26075006900,"Census Tract 69, Jackson County, Michigan",1310,1034,0,820,214,276
1400000US26077003500,"Census Tract 35, Kalamazoo County, Michigan",1740,1621,0,1544,77,119
1400000US26077005501,"Census Tract 55.01, Kalamazoo County, Michigan",1547,1431,11,1336,84,116
1400000US26077005502,"Census Tract 55.02, Kalamazoo County, Michigan",2113,1938,60,1737,141,175
1400000US26077006102,"Census Tract 61.02, Kalamazoo County, Michigan",1453,1291,9,1201,81,162
1400000US26077006103,"Census Tract 61.03, Kalamazoo County, Michigan",1970,1746,0,1609,137,224
1400000US26077006601,"Census Tract 66.01, Kalamazoo County, Michigan",1644,1395,15,1283,97,249
1400000US26077006701,"Census Tract 67.01, Kalamazoo County, Michigan",1040,932,0,863,69,108
1400000US26077006702,"Census Tract 67.02, Kalamazoo County, Michigan",2369,2132,3,2028,101,237
1400000US26079950601,"Census Tract 9506.01, Kalkaska County, Michigan",921,789,10,666,113,132
1400000US26079950602,"Census Tract 9506.02, Kalkaska County, Michigan",757,641,8,515,118,116
1400000US26081011405,"Census Tract 114.05, Kent County, Michigan",1198,1068,0,1003,65,130
1400000US26081011406,"Census Tract 114.06, Kent County, Michigan",2362,2181,15,1956,210,181
1400000US26081012607,"Census Tract 126.07, Kent County, Michigan",2998,2592,0,2178,414,406
1400000US26081012608,"Census Tract 126.08, Kent County, Michigan",1882,1722,0,1635,87,160
1400000US26083000100,"Census Tract 1, Keweenaw County, Michigan",1081,869,6,719,144,212
1400000US26083980100,"Census Tract 9801, Keweenaw County, Michigan",0,0,0,0,0,0
1400000US26083990100,"Census Tract 9901, Keweenaw County, Michigan",0,0,0,0,0,0
1400000US26085961100,"Census Tract 9611, Lake County, Michigan",1340,1021,3,805,213,319
1400000US26015011300,"Census Tract 113, Barry County, Michigan",3024,2646,3,2458,185,378
1400000US26093722300,"Census Tract 7223, Livingston County, Michigan",1278,1101,7,908,186,177
1400000US26093722500,"Census Tract 7225, Livingston County, Michigan",758,717,5,617,95,41
1400000US26093710700,"Census Tract 7107, Livingston County, Michigan",662,600,0,567,33,62
1400000US26093743300,"Census Tract 7433, Livingston County, Michigan",937,899,5,889,5,38
1400000US26093713300,"Census Tract 7133, Livingston County, Michigan",666,512,0,490,22,154
1400000US26093733100,"Census Tract 7331, Livingston County, Michigan",693,647,0,585,62,46
1400000US26093740200,"Census Tract 7402, Livingston County, Michigan",1230,1185,0,1149,36,45
1400000US26093743800,"Census Tract 7438, Livingston County, Michigan",1652,1652,0,1412,240,0
1400000US26093744900,"Census Tract 7449, Livingston County, Michigan",1232,1164,0,1096,68,68
1400000US26093732100,"Census Tract 7321, Livingston County, Michigan",1459,1383,4,1112,267,76
1400000US26093730600,"Census Tract 7306, Livingston County, Michigan",1280,1185,17,1060,108,95
1400000US26093743400,"Census Tract 7434, Livingston County, Michigan",1401,1348,0,1199,149,53
1400000US26085960100,"Census Tract 9601, Lake County, Michigan",1052,798,16,626,156,254
1400000US26125181200,"Census Tract 1812, Oakland County, Michigan",2670,2460,0,2249,211,210
1400000US26125193600,"Census Tract 1936, Oakland County, Michigan",1041,987,0,958,29,54
1400000US26125194300,"Census Tract 1943, Oakland County, Michigan",1475,1443,0,1410,33,32
1400000US26125124000,"Census Tract 1240, Oakland County, Michigan",1801,1664,0,1542,122,137
1400000US26125128100,"Census Tract 1281, Oakland County, Michigan",1124,1044,0,1014,30,80
1400000US26125130400,"Census Tract 1304, Oakland County, Michigan",1163,1099,9,1039,51,64
1400000US26125120000,"Census Tract 1200, Oakland County, Michigan",1066,1000,0,888,112,66
1400000US26125120300,"Census Tract 1203, Oakland County, Michigan",1221,1105,0,1056,49,116
1400000US26125121000,"Census Tract 1210, Oakland County, Michigan",1245,1210,0,1080,130,35
1400000US26125124500,"Census Tract 1245, Oakland County, Michigan",2651,2427,0,2073,354,224
1400000US26125127000,"Census Tract 1270, Oakland County, Michigan",1965,1946,0,1857,89,19
1400000US26125128000,"Census Tract 1280, Oakland County, Michigan",1230,1211,0,1157,54,19
1400000US26125134400,"Census Tract 1344, Oakland County, Michigan",1734,1673,10,1615,48,61
1400000US26125134600,"Census Tract 1346, Oakland County, Michigan",1775,1651,11,1510,130,124
1400000US26125137700,"Census Tract 1377, Oakland County, Michigan",679,640,0,623,17,39
1400000US26125138100,"Census Tract 1381, Oakland County, Michigan",1719,1674,11,1636,27,45
1400000US26125141000,"Census Tract 1410, Oakland County, Michigan",2453,2112,21,1859,232,341
1400000US26125132100,"Census Tract 1321, Oakland County, Michigan",2415,2044,0,1934,110,371
1400000US26125132500,"Census Tract 1325, Oakland County, Michigan",1510,1443,10,1352,81,67
1400000US26125133100,"Census Tract 1331, Oakland County, Michigan",2648,2476,0,2195,281,172
1400000US26125145700,"Census Tract 1457, Oakland County, Michigan",1160,1075,12,973,90,85
1400000US26125141100,"Census Tract 1411, Oakland County, Michigan",1215,965,7,818,140,250
1400000US26163515300,"Census Tract 5153, Wayne County, Michigan",1730,1062,0,794,268,668
1400000US26163516200,"Census Tract 5162, Wayne County, Michigan",262,181,6,107,68,81
1400000US26163516500,"Census Tract 5165, Wayne County, Michigan",1169,1044,6,875,163,125
1400000US26163501500,"Census Tract 5015, Wayne County, Michigan",1478,1340,0,1008,332,138
1400000US26163501700,"Census Tract 5017, Wayne County, Michigan",797,532,7,366,159,265
1400000US26163504000,"Census Tract 5040, Wayne County, Michigan",436,348,0,243,105,88
1400000US26163504800,"Census Tract 5048, Wayne County, Michigan",233,173,0,129,44,60
1400000US26163505100,"Census Tract 5051, Wayne County, Michigan",1578,1116,0,599,517,462
1400000US26163506600,"Census Tract 5066, Wayne County, Michigan",1163,876,0,548,328,287
1400000US26085961200,"Census Tract 9612, Lake County, Michigan",1022,773,10,614,149,249
1400000US26085961300,"Census Tract 9613, Lake County, Michigan",1103,806,12,638,156,297
1400000US26087342100,"Census Tract 3421, Lapeer County, Michigan",1337,1230,0,1112,118,107
1400000US26089990000,"Census Tract 9900, Leelanau County, Michigan",0,0,0,0,0,0
1400000US26091060301,"Census Tract 603.01, Lenawee County, Michigan",1912,1742,20,1618,104,170
1400000US26001970500,"Census Tract 9705, Alcona County, Michigan",1028,801,24,633,144,227
1400000US26001000100,"Census Tract 1, Alcona County, Michigan",894,751,6,697,48,143
1400000US26001970100,"Census Tract 9701, Alcona County, Michigan",1117,928,11,795,122,189
1400000US26001970400,"Census Tract 9704, Alcona County, Michigan",1290,976,21,779,176,314
1400000US26001970600,"Census Tract 9706, Alcona County, Michigan",679,569,5,482,82,110
1400000US26001990000,"Census Tract 9900, Alcona County, Michigan",0,0,0,0,0,0
1400000US26003000100,"Census Tract 1, Alger County, Michigan",1294,1035,5,882,148,259
1400000US26003000200,"Census Tract 2, Alger County, Michigan",1032,856,28,752,76,176
1400000US26003000300,"Census Tract 3, Alger County, Michigan",768,631,12,538,81,137
1400000US26003990000,"Census Tract 9900, Alger County, Michigan",0,0,0,0,0,0
1400000US26005030200,"Census Tract 302, Allegan County, Michigan",1253,1230,22,1166,42,23
1400000US26005030703,"Census Tract 307.03, Allegan County, Michigan",1074,748,3,653,92,326
1400000US26005030704,"Census Tract 307.04, Allegan County, Michigan",1750,1524,14,1288,222,226
1400000US26005030901,"Census Tract 309.01, Allegan County, Michigan",1213,1013,12,860,141,200
1400000US26005030902,"Census Tract 309.02, Allegan County, Michigan",1110,975,20,826,129,135
1400000US26005032200,"Census Tract 322, Allegan County, Michigan",2011,1684,9,1511,164,327
1400000US26005032401,"Census Tract 324.01, Allegan County, Michigan",640,546,0,510,36,94
1400000US26005032402,"Census Tract 324.02, Allegan County, Michigan",1450,1282,10,1170,102,168
1400000US26005032600,"Census Tract 326, Allegan County, Michigan",682,632,0,588,44,50
1400000US26005990000,"Census Tract 9900, Allegan County, Michigan",0,0,0,0,0,0
1400000US26007990000,"Census Tract 9900, Alpena County, Michigan",0,0,0,0,0,0
1400000US26009990000,"Census Tract 9900, Antrim County, Michigan",0,0,0,0,0,0
1400000US26011990000,"Census Tract 9900, Arenac County, Michigan",0,0,0,0,0,0
1400000US26091060302,"Census Tract 603.02, Lenawee County, Michigan",1763,1628,48,1464,116,135
1400000US26091060401,"Census Tract 604.01, Lenawee County, Michigan",1576,1341,24,1113,204,235
1400000US26091060402,"Census Tract 604.02, Lenawee County, Michigan",1443,1119,1,1001,117,324
1400000US26091062100,"Census Tract 621, Lenawee County, Michigan",1688,1501,13,1259,229,187
1400000US26091062200,"Census Tract 622, Lenawee County, Michigan",1050,973,7,841,125,77
1400000US26091062300,"Census Tract 623, Lenawee County, Michigan",2170,2038,3,1995,40,132
1400000US26091062400,"Census Tract 624, Lenawee County, Michigan",2012,1811,8,1671,132,201
1400000US26093712101,"Census Tract 7121.01, Livingston County, Michigan",1178,1150,0,1099,51,28
1400000US26093712102,"Census Tract 7121.02, Livingston County, Michigan",942,921,10,836,75,21
1400000US26093712601,"Census Tract 7126.01, Livingston County, Michigan",1618,1553,0,1475,78,65
1400000US26093712602,"Census Tract 7126.02, Livingston County, Michigan",1122,1118,0,1050,68,4
1400000US26093724001,"Census Tract 7240.01, Livingston County, Michigan",809,718,0,642,76,91
1400000US26093724002,"Census Tract 7240.02, Livingston County, Michigan",890,828,6,773,49,62
1400000US26093724003,"Census Tract 7240.03, Livingston County, Michigan",846,720,0,639,81,126
1400000US26093730101,"Census Tract 7301.01, Livingston County, Michigan",965,881,5,806,70,84
1400000US26093730102,"Census Tract 7301.02, Livingston County, Michigan",1492,1418,10,1331,77,74
1400000US26093733601,"Census Tract 7336.01, Livingston County, Michigan",1126,1060,7,969,84,66
1400000US26157990000,"Census Tract 9900, Tuscola County, Michigan",0,0,0,0,0,0
1400000US26159011800,"Census Tract 118, Van Buren County, Michigan",2825,2485,8,2065,412,340
1400000US26159011900,"Census Tract 119, Van Buren County, Michigan",1916,1751,16,1684,51,165
1400000US26159012000,"Census Tract 120, Van Buren County, Michigan",2274,1920,30,1605,285,354
1400000US26161413401,"Census Tract 4134.01, Washtenaw County, Michigan",1372,1347,0,1314,33,25
1400000US26159990000,"Census Tract 9900, Van Buren County, Michigan",0,0,0,0,0,0
1400000US26161411900,"Census Tract 4119, Washtenaw County, Michigan",1745,1560,46,1123,391,185
1400000US26161412000,"Census Tract 4120, Washtenaw County, Michigan",1523,1210,0,1067,143,313
1400000US26161413402,"Census Tract 4134.02, Washtenaw County, Michigan",1766,1733,0,1674,59,33
1400000US26161413403,"Census Tract 4134.03, Washtenaw County, Michigan",737,698,0,674,24,39
1400000US26161446200,"Census Tract 4462, Washtenaw County, Michigan",992,882,9,752,121,110
1400000US26161446400,"Census Tract 4464, Washtenaw County, Michigan",1223,1087,0,1004,83,136
1400000US26161984000,"Census Tract 9840, Washtenaw County, Michigan",7,7,0,7,0,0
1400000US26163505400,"Census Tract 5054, Wayne County, Michigan",765,585,0,474,111,180
1400000US26163505500,"Census Tract 5055, Wayne County, Michigan",360,262,0,232,30,98
1400000US26163508100,"Census Tract 5081, Wayne County, Michigan",475,296,7,204,85,179
1400000US26163511000,"Census Tract 5110, Wayne County, Michigan",701,498,0,362,136,203
1400000US26163511300,"Census Tract 5113, Wayne County, Michigan",724,544,13,420,111,180
1400000US26163511400,"Census Tract 5114, Wayne County, Michigan",962,670,0,394,276,292
1400000US26163511900,"Census Tract 5119, Wayne County, Michigan",717,559,0,416,143,158
1400000US26163513700,"Census Tract 5137, Wayne County, Michigan",1431,1099,0,931,168,332
1400000US26163514200,"Census Tract 5142, Wayne County, Michigan",990,663,0,482,181,327
1400000US26163515900,"Census Tract 5159, Wayne County, Michigan",469,354,0,219,135,115
1400000US26163516000,"Census Tract 5160, Wayne County, Michigan",817,603,0,492,111,214
1400000US26163517300,"Census Tract 5173, Wayne County, Michigan",1188,1014,0,811,203,174
1400000US26163518900,"Census Tract 5189, Wayne County, Michigan",843,646,0,501,145,197
1400000US26163522500,"Census Tract 5225, Wayne County, Michigan",884,586,0,261,325,298
1400000US26163524900,"Census Tract 5249, Wayne County, Michigan",444,276,10,177,89,168
1400000US26125162400,"Census Tract 1624, Oakland County, Michigan",873,847,0,784,63,26
1400000US26125160400,"Census Tract 1604, Oakland County, Michigan",1420,1193,0,1066,127,227
1400000US26125161400,"Census Tract 1614, Oakland County, Michigan",1468,1072,20,986,66,396
1400000US26125162000,"Census Tract 1620, Oakland County, Michigan",1361,1260,0,1215,45,101
1400000US26125165000,"Census Tract 1650, Oakland County, Michigan",1443,1265,21,1166,78,178
1400000US26125166100,"Census Tract 1661, Oakland County, Michigan",1445,1324,0,1244,80,121
1400000US26125167500,"Census Tract 1675, Oakland County, Michigan",2163,2036,11,1898,127,127
1400000US26125170100,"Census Tract 1701, Oakland County, Michigan",1248,1196,0,1157,39,52
1400000US26125173000,"Census Tract 1730, Oakland County, Michigan",2237,2093,0,1911,182,144
1400000US26125175100,"Census Tract 1751, Oakland County, Michigan",2367,1883,17,1476,390,484
1400000US26125181000,"Census Tract 1810, Oakland County, Michigan",1999,1704,0,1437,267,295
1400000US26125183000,"Census Tract 1830, Oakland County, Michigan",2078,1916,22,1842,52,162
1400000US26125184200,"Census Tract 1842, Oakland County, Michigan",2055,1915,0,1774,141,140
1400000US26125184400,"Census Tract 1844, Oakland County, Michigan",1481,1256,12,1188,56,225
1400000US26125184500,"Census Tract 1845, Oakland County, Michigan",1267,1225,0,1138,87,42
1400000US26125187000,"Census Tract 1870, Oakland County, Michigan",1035,981,5,957,19,54
1400000US26125188000,"Census Tract 1880, Oakland County, Michigan",1445,1422,0,1414,8,23
1400000US26163553200,"Census Tract 5532, Wayne County, Michigan",293,182,0,136,46,111
1400000US26163556600,"Census Tract 5566, Wayne County, Michigan",1284,1233,0,1172,61,51
1400000US26163560300,"Census Tract 5603, Wayne County, Michigan",1412,1359,0,1305,54,53
1400000US26163565100,"Census Tract 5651, Wayne County, Michigan",1532,1412,35,1173,204,120
1400000US26163596200,"Census Tract 5962, Wayne County, Michigan",1625,1522,0,1420,102,103
1400000US26023951100,"Census Tract 9511, Branch County, Michigan",1309,1087,36,901,150,222
1400000US26163539100,"Census Tract 5391, Wayne County, Michigan",753,583,4,399,180,170
1400000US26163541800,"Census Tract 5418, Wayne County, Michigan",1065,889,0,681,208,176
1400000US26023950900,"Census Tract 9509, Branch County, Michigan",887,819,5,777,37,68
1400000US26023950100,"Census Tract 9501, Branch County, Michigan",1520,1235,9,1074,152,285
1400000US26023951000,"Census Tract 9510, Branch County, Michigan",1081,949,0,866,83,132
1400000US26023951200,"Census Tract 9512, Branch County, Michigan",1659,1438,15,1205,218,221
1400000US26023950200,"Census Tract 9502, Branch County, Michigan",1437,1236,20,1094,122,201
1400000US26023950800,"Census Tract 9508, Branch County, Michigan",1475,1138,16,930,192,337
1400000US26023950300,"Census Tract 9503, Branch County, Michigan",1496,1284,28,1072,184,212
1400000US26075000100,"Census Tract 1, Jackson County, Michigan",1122,940,0,836,104,182
1400000US26075000800,"Census Tract 8, Jackson County, Michigan",2017,1814,38,1610,166,203
1400000US26075001200,"Census Tract 12, Jackson County, Michigan",857,715,0,588,127,142
1400000US26075000600,"Census Tract 6, Jackson County, Michigan",476,320,0,269,51,156
1400000US26075001000,"Census Tract 10, Jackson County, Michigan",911,738,0,638,100,173
1400000US26121001901,"Census Tract 19.01, Muskegon County, Michigan",1381,1255,0,1053,202,126
1400000US26121003000,"Census Tract 30, Muskegon County, Michigan",1512,1297,11,1115,171,215
1400000US26127010300,"Census Tract 103, Oceana County, Michigan",2558,2151,20,1891,240,407
1400000US26127010500,"Census Tract 105, Oceana County, Michigan",1124,918,19,693,206,206
1400000US26127010400,"Census Tract 104, Oceana County, Michigan",1474,1256,17,982,257,218
1400000US26089970500,"Census Tract 9705, Leelanau County, Michigan",1989,1831,30,1674,127,158
1400000US26089970400,"Census Tract 9704, Leelanau County, Michigan",748,698,11,627,60,50
1400000US26089970100,"Census Tract 9701, Leelanau County, Michigan",965,862,0,742,120,103
1400000US26089970200,"Census Tract 9702, Leelanau County, Michigan",2163,1932,12,1719,201,231
1400000US26125170400,"Census Tract 1704, Oakland County, Michigan",1799,1623,8,1554,61,176
1400000US26125171600,"Census Tract 1716, Oakland County, Michigan",858,725,6,520,199,133
1400000US26125173500,"Census Tract 1735, Oakland County, Michigan",1502,1458,0,1307,151,44
1400000US26125121500,"Census Tract 1215, Oakland County, Michigan",1515,1333,0,1266,67,182
1400000US26125122200,"Census Tract 1222, Oakland County, Michigan",1299,1271,10,1213,48,28
1400000US26125184700,"Census Tract 1847, Oakland County, Michigan",753,715,5,658,52,38
1400000US26125175000,"Census Tract 1750, Oakland County, Michigan",1440,1184,7,1056,121,256
1400000US26125175200,"Census Tract 1752, Oakland County, Michigan",1719,1517,17,1358,142,202
1400000US26125181300,"Census Tract 1813, Oakland County, Michigan",2302,1952,0,1730,222,350
1400000US26125191200,"Census Tract 1912, Oakland County, Michigan",1999,1739,0,1650,89,260
1400000US26125193400,"Census Tract 1934, Oakland County, Michigan",1466,1456,0,1389,67,10
1400000US26125193500,"Census Tract 1935, Oakland County, Michigan",1040,937,0,813,124,103
1400000US26125194200,"Census Tract 1942, Oakland County, Michigan",840,800,0,769,31,40
1400000US26125122400,"Census Tract 1224, Oakland County, Michigan",2549,2370,0,2203,167,179
1400000US26125123000,"Census Tract 1230, Oakland County, Michigan",816,763,5,681,77,53
1400000US26125126200,"Census Tract 1262, Oakland County, Michigan",993,943,0,905,38,50
1400000US26125196400,"Census Tract 1964, Oakland County, Michigan",1372,1355,0,1341,14,17
1400000US26125192200,"Census Tract 1922, Oakland County, Michigan",1941,1930,10,1849,71,11
1400000US26125192500,"Census Tract 1925, Oakland County, Michigan",1057,1057,0,1025,32,0
1400000US26125192700,"Census Tract 1927, Oakland County, Michigan",1167,1107,15,1062,30,60
1400000US26125197200,"Census Tract 1972, Oakland County, Michigan",1241,1186,0,1113,73,55
1400000US26125197400,"Census Tract 1974, Oakland County, Michigan",1011,765,0,720,45,246
1400000US26163524000,"Census Tract 5240, Wayne County, Michigan",989,688,0,516,172,301
1400000US26125197500,"Census Tract 1975, Oakland County, Michigan",1662,1629,0,1473,156,33
1400000US26125128600,"Census Tract 1286, Oakland County, Michigan",1178,1136,9,1104,23,42
1400000US26163523800,"Census Tract 5238, Wayne County, Michigan",1308,1051,0,772,279,257
1400000US26163524100,"Census Tract 5241, Wayne County, Michigan",1356,873,0,656,217,483
1400000US26163525400,"Census Tract 5254, Wayne County, Michigan",830,487,9,312,166,343
1400000US26163525700,"Census Tract 5257, Wayne County, Michigan",1589,1364,0,1066,298,225
1400000US26163526500,"Census Tract 5265, Wayne County, Michigan",762,488,10,357,121,274
1400000US26163530300,"Census Tract 5303, Wayne County, Michigan",542,478,7,329,142,64
1400000US26163531700,"Census Tract 5317, Wayne County, Michigan",809,534,0,369,165,275
1400000US26163532600,"Census Tract 5326, Wayne County, Michigan",1069,788,0,423,365,281
1400000US26163532700,"Census Tract 5327, Wayne County, Michigan",270,186,0,93,93,84
1400000US26163533200,"Census Tract 5332, Wayne County, Michigan",369,218,0,181,37,151
1400000US26163533700,"Census Tract 5337, Wayne County, Michigan",450,327,4,204,119,123
1400000US26163521900,"Census Tract 5219, Wayne County, Michigan",1445,1172,9,926,237,273
1400000US26163516900,"Census Tract 5169, Wayne County, Michigan",1528,1039,19,704,316,489
1400000US26163521400,"Census Tract 5214, Wayne County, Michigan",555,447,0,403,44,108
1400000US26163522400,"Census Tract 5224, Wayne County, Michigan",518,362,0,204,158,156
1400000US26163523200,"Census Tract 5232, Wayne County, Michigan",1130,942,0,673,269,188
1400000US26163524700,"Census Tract 5247, Wayne County, Michigan",1720,1211,0,772,439,509
1400000US26163525800,"Census Tract 5258, Wayne County, Michigan",597,388,0,331,57,209
1400000US26099268000,"Census Tract 2680, Macomb County, Michigan",2474,2151,6,2060,85,323
1400000US26099206700,"Census Tract 2067, Macomb County, Michigan",1660,1425,8,1318,99,235
1400000US26099214000,"Census Tract 2140, Macomb County, Michigan",918,845,0,750,95,73
1400000US26099255400,"Census Tract 2554, Macomb County, Michigan",947,852,0,824,28,95
1400000US26099258700,"Census Tract 2587, Macomb County, Michigan",886,826,0,651,175,60
1400000US26099260000,"Census Tract 2600, Macomb County, Michigan",1298,1164,9,1116,39,134
1400000US26099261500,"Census Tract 2615, Macomb County, Michigan",1480,1245,10,1148,87,235
1400000US26099267600,"Census Tract 2676, Macomb County, Michigan",566,472,0,463,9,94
1400000US26099231400,"Census Tract 2314, Macomb County, Michigan",1869,1717,9,1639,69,152
1400000US26099224000,"Census Tract 2240, Macomb County, Michigan",4244,4036,0,4009,27,208
1400000US26099224200,"Census Tract 2242, Macomb County, Michigan",2880,2773,0,2643,130,107
1400000US26099228000,"Census Tract 2280, Macomb County, Michigan",1572,1321,0,1204,117,251
1400000US26099231800,"Census Tract 2318, Macomb County, Michigan",1585,1492,16,1356,120,93
1400000US26099240500,"Census Tract 2405, Macomb County, Michigan",1011,945,0,825,120,66
1400000US26099242500,"Census Tract 2425, Macomb County, Michigan",3080,2791,0,2589,202,289
1400000US26099250100,"Census Tract 2501, Macomb County, Michigan",966,892,6,832,54,74
1400000US26099251800,"Census Tract 2518, Macomb County, Michigan",1885,1600,0,1505,95,285
1400000US26099252100,"Census Tract 2521, Macomb County, Michigan",957,872,0,849,23,85
1400000US26163507100,"Census Tract 5071, Wayne County, Michigan",873,637,10,417,210,236
1400000US26163531900,"Census Tract 5319, Wayne County, Michigan",255,203,7,133,63,52
1400000US26163532200,"Census Tract 5322, Wayne County, Michigan",535,382,6,248,128,153
1400000US26125141300,"Census Tract 1413, Oakland County, Michigan",1396,1090,17,1013,60,306
1400000US26125142100,"Census Tract 1421, Oakland County, Michigan",517,417,0,366,51,100
1400000US26125150100,"Census Tract 1501, Oakland County, Michigan",1643,1483,0,1365,118,160
1400000US26125150600,"Census Tract 1506, Oakland County, Michigan",1053,1043,12,1011,20,10
1400000US26125156100,"Census Tract 1561, Oakland County, Michigan",1514,1497,21,1465,11,17
1400000US26125150700,"Census Tract 1507, Oakland County, Michigan",1568,1533,0,1493,40,35
1400000US26125152700,"Census Tract 1527, Oakland County, Michigan",1110,1056,0,1038,18,54
1400000US26125154500,"Census Tract 1545, Oakland County, Michigan",859,838,0,832,6,21
1400000US26125157800,"Census Tract 1578, Oakland County, Michigan",1649,1464,10,1414,40,185
1400000US26125157900,"Census Tract 1579, Oakland County, Michigan",1024,1008,0,961,47,16
1400000US26125160600,"Census Tract 1606, Oakland County, Michigan",1705,1563,0,1485,78,142
1400000US26027001100,"Census Tract 11, Cass County, Michigan",1093,976,17,855,104,117
1400000US26027001200,"Census Tract 12, Cass County, Michigan",1306,1184,8,1049,127,122
1400000US26027001000,"Census Tract 10, Cass County, Michigan",1479,1354,20,1217,117,125
1400000US26027001500,"Census Tract 15, Cass County, Michigan",1660,1461,18,1291,152,199
1400000US26143970700,"Census Tract 9707, Roscommon County, Michigan",1239,1093,21,961,111,146
1400000US26143971100,"Census Tract 9711, Roscommon County, Michigan",1278,974,0,826,148,304
1400000US26143970100,"Census Tract 9701, Roscommon County, Michigan",856,654,14,543,97,202
1400000US26143971000,"Census Tract 9710, Roscommon County, Michigan",1660,1356,0,1232,124,304
1400000US26143970500,"Census Tract 9705, Roscommon County, Michigan",443,396,0,383,13,47
1400000US26143970600,"Census Tract 9706, Roscommon County, Michigan",1087,949,0,863,86,138
1400000US26143970200,"Census Tract 9702, Roscommon County, Michigan",764,611,5,572,34,153
1400000US26143970400,"Census Tract 9704, Roscommon County, Michigan",979,885,9,809,67,94
1400000US26143970300,"Census Tract 9703, Roscommon County, Michigan",1245,1121,5,1002,114,124
1400000US26163504400,"Census Tract 5044, Wayne County, Michigan",574,513,0,404,109,61
1400000US26163562500,"Census Tract 5625, Wayne County, Michigan",971,832,0,757,75,139
1400000US26163563500,"Census Tract 5635, Wayne County, Michigan",1923,1892,0,1823,69,31
1400000US26163563700,"Census Tract 5637, Wayne County, Michigan",621,604,0,585,19,17
1400000US26163564000,"Census Tract 5640, Wayne County, Michigan",995,884,0,824,60,111
1400000US26163564300,"Census Tract 5643, Wayne County, Michigan",1072,872,0,852,20,200
1400000US26163566500,"Census Tract 5665, Wayne County, Michigan",1073,753,0,563,190,320
1400000US26163567300,"Census Tract 5673, Wayne County, Michigan",1913,1735,0,1582,153,178
1400000US26163567400,"Census Tract 5674, Wayne County, Michigan",1343,1173,15,1016,142,170
1400000US26163570400,"Census Tract 5704, Wayne County, Michigan",1883,1616,0,1115,501,267
1400000US26163570600,"Census Tract 5706, Wayne County, Michigan",736,668,0,424,244,68
1400000US26163571000,"Census Tract 5710, Wayne County, Michigan",829,631,0,390,241,198
1400000US26163572200,"Census Tract 5722, Wayne County, Michigan",2295,1916,0,1698,218,379
1400000US26163572400,"Census Tract 5724, Wayne County, Michigan",471,431,2,319,110,40
1400000US26163572800,"Census Tract 5728, Wayne County, Michigan",2094,1934,28,1657,249,160
1400000US26163572900,"Census Tract 5729, Wayne County, Michigan",954,891,0,776,115,63
1400000US26163574000,"Census Tract 5740, Wayne County, Michigan",1508,1288,5,1057,226,220
1400000US26163574900,"Census Tract 5749, Wayne County, Michigan",934,693,7,571,115,241
1400000US26099255800,"Census Tract 2558, Macomb County, Michigan",1015,911,0,830,81,104
1400000US26099256200,"Census Tract 2562, Macomb County, Michigan",687,592,0,546,46,95
1400000US26041970300,"Census Tract 9703, Delta County, Michigan",1008,812,7,673,132,196
1400000US26041970800,"Census Tract 9708, Delta County, Michigan",1842,1439,0,1286,153,403
1400000US26041970500,"Census Tract 9705, Delta County, Michigan",1714,1440,47,1207,186,274
1400000US26041970400,"Census Tract 9704, Delta County, Michigan",2266,1922,22,1715,185,344
1400000US26041971100,"Census Tract 9711, Delta County, Michigan",1501,1306,0,1159,147,195
1400000US26041970600,"Census Tract 9706, Delta County, Michigan",1653,1422,0,1260,162,231
1400000US26053950400,"Census Tract 9504, Gogebic County, Michigan",399,323,7,247,69,76
1400000US26041970900,"Census Tract 9709, Delta County, Michigan",1288,1108,0,972,136,180
1400000US26053950100,"Census Tract 9501, Gogebic County, Michigan",633,514,13,344,157,119
1400000US26053950600,"Census Tract 9506, Gogebic County, Michigan",1411,1155,14,921,220,256
1400000US26053950300,"Census Tract 9503, Gogebic County, Michigan",1072,795,3,645,147,277
1400000US26053950200,"Census Tract 9502, Gogebic County, Michigan",1056,818,19,661,138,238
1400000US26053950700,"Census Tract 9507, Gogebic County, Michigan",973,789,11,650,128,184
1400000US26053950500,"Census Tract 9505, Gogebic County, Michigan",1075,754,0,600,154,321
1400000US26047970200,"Census Tract 9702, Emmet County, Michigan",2248,2012,28,1753,231,236
1400000US26047970100,"Census Tract 9701, Emmet County, Michigan",985,840,13,707,120,145
1400000US26047970800,"Census Tract 9708, Emmet County, Michigan",2174,1855,11,1700,144,319
1400000US26047970600,"Census Tract 9706, Emmet County, Michigan",2095,1897,4,1743,150,198
1400000US26047970700,"Census Tract 9707, Emmet County, Michigan",1804,1551,8,1444,99,253
1400000US26047970400,"Census Tract 9704, Emmet County, Michigan",1293,1180,3,1015,162,113
1400000US26047970300,"Census Tract 9703, Emmet County, Michigan",2013,1829,23,1623,183,184
1400000US26047970500,"Census Tract 9705, Emmet County, Michigan",1898,1647,19,1440,188,251
1400000US26099260100,"Census Tract 2601, Macomb County, Michigan",1324,1136,7,1087,42,188
1400000US26099261300,"Census Tract 2613, Macomb County, Michigan",1113,943,8,849,86,170
1400000US26099260400,"Census Tract 2604, Macomb County, Michigan",1723,1507,18,1432,57,216
1400000US26099261600,"Census Tract 2616, Macomb County, Michigan",542,505,0,465,40,37
1400000US26099262000,"Census Tract 2620, Macomb County, Michigan",1354,1069,0,1005,64,285
1400000US26099263600,"Census Tract 2636, Macomb County, Michigan",1768,1511,0,1359,152,257
1400000US26099263700,"Census Tract 2637, Macomb County, Michigan",1713,1449,0,1339,110,264
1400000US26099215300,"Census Tract 2153, Macomb County, Michigan",1835,1710,0,1568,142,125
1400000US26099223500,"Census Tract 2235, Macomb County, Michigan",664,595,0,551,44,69
1400000US26099224600,"Census Tract 2246, Macomb County, Michigan",2630,2374,0,2226,148,256
1400000US26099227300,"Census Tract 2273, Macomb County, Michigan",1906,1672,0,1563,109,234
1400000US26099268100,"Census Tract 2681, Macomb County, Michigan",1065,820,0,714,106,245
1400000US26099263800,"Census Tract 2638, Macomb County, Michigan",1067,715,0,543,172,352
1400000US26099263900,"Census Tract 2639, Macomb County, Michigan",1234,1005,9,876,120,229
1400000US26099264200,"Census Tract 2642, Macomb County, Michigan",1688,1419,0,1257,162,269
1400000US26065003500,"Census Tract 35, Ingham County, Michigan",1372,1266,8,1052,206,106
1400000US26163525000,"Census Tract 5250, Wayne County, Michigan",305,192,0,93,99,113
1400000US26163527200,"Census Tract 5272, Wayne County, Michigan",268,190,0,124,66,78
1400000US26163527300,"Census Tract 5273, Wayne County, Michigan",295,212,0,144,68,83
1400000US26163530900,"Census Tract 5309, Wayne County, Michigan",676,414,0,299,115,262
1400000US26163533900,"Census Tract 5339, Wayne County, Michigan",1891,1442,0,1122,320,449
1400000US26163575500,"Census Tract 5755, Wayne County, Michigan",1458,1309,0,1209,100,149
1400000US26163576700,"Census Tract 5767, Wayne County, Michigan",1395,1263,7,1118,138,132
1400000US26163572100,"Census Tract 5721, Wayne County, Michigan",2121,1753,0,1493,260,368
1400000US26163572600,"Census Tract 5726, Wayne County, Michigan",1901,1607,0,1345,262,294
1400000US26163575200,"Census Tract 5752, Wayne County, Michigan",1570,1456,8,1185,263,114
1400000US26163576200,"Census Tract 5762, Wayne County, Michigan",980,902,18,826,58,78
1400000US26163576300,"Census Tract 5763, Wayne County, Michigan",920,838,0,720,118,82
1400000US26163577100,"Census Tract 5771, Wayne County, Michigan",961,848,0,631,217,113
1400000US26163579300,"Census Tract 5793, Wayne County, Michigan",947,689,0,451,238,258
1400000US26163534500,"Census Tract 5345, Wayne County, Michigan",240,207,0,156,51,33
1400000US26163579600,"Census Tract 5796, Wayne County, Michigan",1077,752,0,548,204,325
1400000US26163580100,"Census Tract 5801, Wayne County, Michigan",847,759,31,604,124,88
1400000US26163580500,"Census Tract 5805, Wayne County, Michigan",1265,1110,9,1070,31,155
1400000US26163534700,"Census Tract 5347, Wayne County, Michigan",1196,849,0,605,244,347
1400000US26163535600,"Census Tract 5356, Wayne County, Michigan",1591,1398,0,1059,339,193
1400000US26163536700,"Census Tract 5367, Wayne County, Michigan",387,210,0,138,72,177
1400000US26163536800,"Census Tract 5368, Wayne County, Michigan",644,532,0,354,178,112
1400000US26163537800,"Census Tract 5378, Wayne County, Michigan",654,527,5,279,243,127
1400000US26125161200,"Census Tract 1612, Oakland County, Michigan",1862,1842,0,1794,48,20
1400000US26125171400,"Census Tract 1714, Oakland County, Michigan",2317,2134,0,1850,284,183
1400000US26125171500,"Census Tract 1715, Oakland County, Michigan",1986,1725,0,1479,246,261
1400000US26125173300,"Census Tract 1733, Oakland County, Michigan",763,688,0,638,50,75
1400000US26125180200,"Census Tract 1802, Oakland County, Michigan",1751,1562,0,1420,142,189
1400000US26125181400,"Census Tract 1814, Oakland County, Michigan",1351,1283,0,1235,48,68
1400000US26125183100,"Census Tract 1831, Oakland County, Michigan",1829,1741,9,1675,57,88
1400000US26125183200,"Census Tract 1832, Oakland County, Michigan",1763,1622,0,1517,105,141
1400000US26125183500,"Census Tract 1835, Oakland County, Michigan",1121,1063,0,863,200,58
1400000US26125183600,"Census Tract 1836, Oakland County, Michigan",2026,1915,11,1822,82,111
1400000US26125183700,"Census Tract 1837, Oakland County, Michigan",2567,2382,0,2266,116,185
1400000US26163532300,"Census Tract 5323, Wayne County, Michigan",380,343,0,305,38,37
1400000US26163533600,"Census Tract 5336, Wayne County, Michigan",670,402,5,278,119,268
1400000US26163535300,"Census Tract 5353, Wayne County, Michigan",1560,1278,0,801,477,282
1400000US26163576000,"Census Tract 5760, Wayne County, Michigan",754,706,25,592,89,48
1400000US26163576100,"Census Tract 5761, Wayne County, Michigan",2353,2083,0,1813,270,270
1400000US26163577300,"Census Tract 5773, Wayne County, Michigan",1229,1026,0,895,131,203
1400000US26163580900,"Census Tract 5809, Wayne County, Michigan",1743,1462,0,1344,118,281
1400000US26163581100,"Census Tract 5811, Wayne County, Michigan",1680,1504,29,1363,112,176
1400000US26163583400,"Census Tract 5834, Wayne County, Michigan",1975,1714,0,1530,184,261
1400000US26163584000,"Census Tract 5840, Wayne County, Michigan",1605,1525,20,1354,151,80
1400000US26163585600,"Census Tract 5856, Wayne County, Michigan",1277,1146,0,969,177,131
1400000US26163585900,"Census Tract 5859, Wayne County, Michigan",1276,1088,12,789,287,188
1400000US26163589300,"Census Tract 5893, Wayne County, Michigan",1467,1342,0,1158,184,125
1400000US26163593000,"Census Tract 5930, Wayne County, Michigan",2270,2124,17,1955,152,146
1400000US26163595000,"Census Tract 5950, Wayne County, Michigan",1684,1424,0,1242,182,260
1400000US26163568500,"Census Tract 5685, Wayne County, Michigan",1610,1347,6,988,353,263
1400000US26163552800,"Census Tract 5528, Wayne County, Michigan",1184,825,10,624,191,359
1400000US26163561200,"Census Tract 5612, Wayne County, Michigan",2118,2068,0,2036,32,50
1400000US26163561300,"Census Tract 5613, Wayne County, Michigan",2645,2620,0,2565,55,25
1400000US26163564401,"Census Tract 5644.01, Wayne County, Michigan",1689,1650,0,1559,91,39
1400000US26163564402,"Census Tract 5644.02, Wayne County, Michigan",1533,1523,0,1361,162,10
1400000US26163564501,"Census Tract 5645.01, Wayne County, Michigan",1575,1569,0,1550,19,6
1400000US26163564502,"Census Tract 5645.02, Wayne County, Michigan",1268,1259,0,1222,37,9
1400000US26163564503,"Census Tract 5645.03, Wayne County, Michigan",1303,1303,0,1187,116,0
1400000US26163564504,"Census Tract 5645.04, Wayne County, Michigan",2512,2441,0,2379,62,71
1400000US26163567201,"Census Tract 5672.01, Wayne County, Michigan",1356,1296,11,1175,110,60
1400000US26163573701,"Census Tract 5737.01, Wayne County, Michigan",506,450,8,399,43,56
1400000US26163567202,"Census Tract 5672.02, Wayne County, Michigan",1309,1206,0,1081,125,103
1400000US26163568800,"Census Tract 5688, Wayne County, Michigan",1717,1501,0,1265,236,216
1400000US26163568900,"Census Tract 5689, Wayne County, Michigan",1218,1081,0,999,82,137
1400000US26163573702,"Census Tract 5737.02, Wayne County, Michigan",1593,1409,0,1080,329,184
1400000US26163574202,"Census Tract 5742.02, Wayne County, Michigan",1202,993,9,911,73,209
1400000US26125142400,"Census Tract 1424, Oakland County, Michigan",1292,868,18,750,100,424
1400000US26125145300,"Census Tract 1453, Oakland County, Michigan",1866,1736,0,1680,56,130
1400000US26125151000,"Census Tract 1510, Oakland County, Michigan",1754,1715,0,1656,59,39
1400000US26125152900,"Census Tract 1529, Oakland County, Michigan",1950,1776,29,1692,55,174
1400000US26125156400,"Census Tract 1564, Oakland County, Michigan",1515,1460,13,1371,76,55
1400000US26125160000,"Census Tract 1600, Oakland County, Michigan",1586,1567,8,1506,53,19
1400000US26125160800,"Census Tract 1608, Oakland County, Michigan",1721,1545,0,1417,128,176
1400000US26125160900,"Census Tract 1609, Oakland County, Michigan",2249,2088,0,1874,214,161
1400000US26125161700,"Census Tract 1617, Oakland County, Michigan",1117,1102,6,970,126,15
1400000US26125162300,"Census Tract 1623, Oakland County, Michigan",1604,1467,0,1361,106,137
1400000US26125165100,"Census Tract 1651, Oakland County, Michigan",1715,1578,0,1445,133,137
1400000US26125167000,"Census Tract 1670, Oakland County, Michigan",2103,1986,0,1986,0,117
1400000US26125167900,"Census Tract 1679, Oakland County, Michigan",1088,1043,6,1013,24,45
1400000US26125170300,"Census Tract 1703, Oakland County, Michigan",1121,1071,9,995,67,50
1400000US26125171000,"Census Tract 1710, Oakland County, Michigan",2045,1602,18,1433,151,443
1400000US26125171300,"Census Tract 1713, Oakland County, Michigan",1222,1103,10,994,99,119
1400000US26125125600,"Census Tract 1256, Oakland County, Michigan",1183,1170,15,1039,116,13
1400000US26125126300,"Census Tract 1263, Oakland County, Michigan",1758,1661,10,1536,115,97
1400000US26125128500,"Census Tract 1285, Oakland County, Michigan",1263,1210,8,1076,126,53
1400000US26125131500,"Census Tract 1315, Oakland County, Michigan",1446,1386,0,1336,50,60
1400000US26125141500,"Census Tract 1415, Oakland County, Michigan",2421,2103,0,1712,391,318
1400000US26125170200,"Census Tract 1702, Oakland County, Michigan",1427,1353,0,1271,82,74
1400000US26125168400,"Census Tract 1684, Oakland County, Michigan",1388,1337,0,1279,58,51
1400000US26125172500,"Census Tract 1725, Oakland County, Michigan",1078,868,0,666,202,210
1400000US26125175300,"Census Tract 1753, Oakland County, Michigan",1718,1584,0,1391,193,134
1400000US26125181100,"Census Tract 1811, Oakland County, Michigan",1156,1014,0,946,68,142
1400000US26125183300,"Census Tract 1833, Oakland County, Michigan",1516,1416,0,1333,83,100
1400000US26125183800,"Census Tract 1838, Oakland County, Michigan",2015,1837,0,1808,29,178
1400000US26125184100,"Census Tract 1841, Oakland County, Michigan",1459,1444,0,1355,89,15
1400000US26163569600,"Census Tract 5696, Wayne County, Michigan",1274,1155,8,1068,79,119
1400000US26163570200,"Census Tract 5702, Wayne County, Michigan",995,929,0,774,155,66
1400000US26163571900,"Census Tract 5719, Wayne County, Michigan",1193,986,0,915,71,207
1400000US26163517200,"Census Tract 5172, Wayne County, Michigan",893,833,8,736,89,60
1400000US26163520700,"Census Tract 5207, Wayne County, Michigan",1872,1634,11,1443,180,238
1400000US26163583600,"Census Tract 5836, Wayne County, Michigan",970,883,0,809,74,87
1400000US26163583800,"Census Tract 5838, Wayne County, Michigan",1861,1595,0,1376,219,266
1400000US26163586300,"Census Tract 5863, Wayne County, Michigan",747,661,0,589,72,86
1400000US26163590400,"Census Tract 5904, Wayne County, Michigan",2459,2378,10,2252,116,81
1400000US26163590500,"Census Tract 5905, Wayne County, Michigan",2419,1986,53,1778,155,433
1400000US26163591800,"Census Tract 5918, Wayne County, Michigan",2245,2022,0,1720,302,223
1400000US26163510400,"Census Tract 5104, Wayne County, Michigan",299,196,0,176,20,103
1400000US26163513900,"Census Tract 5139, Wayne County, Michigan",662,482,0,336,146,180
1400000US26163506200,"Census Tract 5062, Wayne County, Michigan",700,601,0,338,263,99
1400000US26163506900,"Census Tract 5069, Wayne County, Michigan",1269,1004,0,669,335,265
1400000US26163514100,"Census Tract 5141, Wayne County, Michigan",924,706,0,509,197,218
1400000US26163515600,"Census Tract 5156, Wayne County, Michigan",622,445,5,357,83,177
1400000US26163516300,"Census Tract 5163, Wayne County, Michigan",242,174,0,90,84,68
1400000US26163521100,"Census Tract 5211, Wayne County, Michigan",782,577,5,519,53,205
1400000US26163521300,"Census Tract 5213, Wayne County, Michigan",295,262,0,218,44,33
1400000US26163522200,"Census Tract 5222, Wayne County, Michigan",145,97,0,69,28,48
1400000US26163530200,"Census Tract 5302, Wayne County, Michigan",1294,1042,24,729,289,252
1400000US26163531300,"Census Tract 5313, Wayne County, Michigan",442,357,0,241,116,85
1400000US26163531800,"Census Tract 5318, Wayne County, Michigan",625,397,0,244,153,228
1400000US26163533000,"Census Tract 5330, Wayne County, Michigan",500,393,0,211,182,107
1400000US26163593200,"Census Tract 5932, Wayne County, Michigan",1689,1590,9,1487,94,99
1400000US26163598000,"Census Tract 5980, Wayne County, Michigan",1373,1144,0,1024,120,229
1400000US26163542400,"Census Tract 5424, Wayne County, Michigan",991,899,0,625,274,92
1400000US26163543400,"Census Tract 5434, Wayne County, Michigan",1399,1215,0,942,273,184
1400000US26163543600,"Census Tract 5436, Wayne County, Michigan",424,300,0,233,67,124
1400000US26163545100,"Census Tract 5451, Wayne County, Michigan",386,323,0,183,140,63
1400000US26163500100,"Census Tract 5001, Wayne County, Michigan",1371,1205,0,943,262,166
1400000US26163500900,"Census Tract 5009, Wayne County, Michigan",1267,946,0,704,242,321
1400000US26163501000,"Census Tract 5010, Wayne County, Michigan",999,838,7,611,220,161
1400000US26163501800,"Census Tract 5018, Wayne County, Michigan",1696,1525,0,1297,228,171
1400000US26163503500,"Census Tract 5035, Wayne County, Michigan",1013,747,0,540,207,266
1400000US26163504700,"Census Tract 5047, Wayne County, Michigan",642,473,0,299,174,169
1400000US26163506500,"Census Tract 5065, Wayne County, Michigan",747,593,0,341,252,154
1400000US26163507800,"Census Tract 5078, Wayne County, Michigan",146,105,0,54,51,41
1400000US26125190400,"Census Tract 1904, Oakland County, Michigan",1201,1167,19,1095,53,34
1400000US26125191000,"Census Tract 1910, Oakland County, Michigan",843,791,0,769,22,52
1400000US26125193700,"Census Tract 1937, Oakland County, Michigan",1907,1701,0,1575,126,206
1400000US26125194000,"Census Tract 1940, Oakland County, Michigan",2438,2367,0,2367,0,71
1400000US26125194400,"Census Tract 1944, Oakland County, Michigan",1447,1188,0,1094,94,259
1400000US26125196600,"Census Tract 1966, Oakland County, Michigan",761,730,0,690,40,31
1400000US26125184600,"Census Tract 1846, Oakland County, Michigan",1494,1417,0,1377,40,77
1400000US26125190500,"Census Tract 1905, Oakland County, Michigan",821,796,0,773,23,25
1400000US26125191100,"Census Tract 1911, Oakland County, Michigan",1225,1138,0,1024,114,87
1400000US26125192000,"Census Tract 1920, Oakland County, Michigan",2620,2350,20,2262,68,270
1400000US26125192400,"Census Tract 1924, Oakland County, Michigan",1950,1765,19,1589,157,185
1400000US26125193100,"Census Tract 1931, Oakland County, Michigan",1552,1519,0,1425,94,33
1400000US26125194500,"Census Tract 1945, Oakland County, Michigan",653,466,26,411,29,187
1400000US26163507300,"Census Tract 5073, Wayne County, Michigan",758,590,9,452,129,168
1400000US26163507400,"Census Tract 5074, Wayne County, Michigan",960,670,10,338,322,290
1400000US26163512900,"Census Tract 5129, Wayne County, Michigan",500,308,0,216,92,192
1400000US26163516700,"Census Tract 5167, Wayne County, Michigan",1766,1210,0,1067,143,556
1400000US26163517000,"Census Tract 5170, Wayne County, Michigan",2391,2235,0,1781,454,156
1400000US26163542900,"Census Tract 5429, Wayne County, Michigan",1423,1342,10,1163,169,81
1400000US26163517100,"Census Tract 5171, Wayne County, Michigan",821,705,0,609,96,116
1400000US26163518000,"Census Tract 5180, Wayne County, Michigan",1347,1219,0,965,254,128
1400000US26163518400,"Census Tract 5184, Wayne County, Michigan",137,71,0,43,28,66
1400000US26163538900,"Census Tract 5389, Wayne County, Michigan",1569,1220,0,1007,213,349
1400000US26163542200,"Census Tract 5422, Wayne County, Michigan",1312,1094,0,789,305,218
1400000US26163542500,"Census Tract 5425, Wayne County, Michigan",1001,924,8,575,341,77
1400000US26163543500,"Census Tract 5435, Wayne County, Michigan",422,300,0,228,72,122
1400000US26163543800,"Census Tract 5438, Wayne County, Michigan",355,283,0,212,71,72
1400000US26163544100,"Census Tract 5441, Wayne County, Michigan",870,752,0,609,143,118
1400000US26163545200,"Census Tract 5452, Wayne County, Michigan",970,748,19,521,208,222
1400000US26163545800,"Census Tract 5458, Wayne County, Michigan",1559,1377,0,960,417,182
1400000US26163545900,"Census Tract 5459, Wayne County, Michigan",1309,1138,21,877,240,171
1400000US26163546200,"Census Tract 5462, Wayne County, Michigan",1292,1192,8,899,285,100
1400000US26163546600,"Census Tract 5466, Wayne County, Michigan",674,527,0,327,200,147
1400000US26163550400,"Census Tract 5504, Wayne County, Michigan",753,709,0,678,31,44
1400000US26163551700,"Census Tract 5517, Wayne County, Michigan",1275,1177,6,1127,44,98
1400000US26163554400,"Census Tract 5544, Wayne County, Michigan",1138,1005,0,901,104,133
1400000US26163554600,"Census Tract 5546, Wayne County, Michigan",1441,1337,0,1272,65,104
1400000US26163555300,"Census Tract 5553, Wayne County, Michigan",1125,1020,0,915,105,105
1400000US26163556500,"Census Tract 5565, Wayne County, Michigan",1113,943,11,915,17,170
1400000US26163556800,"Census Tract 5568, Wayne County, Michigan",674,658,0,654,4,16
1400000US26163557100,"Census Tract 5571, Wayne County, Michigan",963,908,11,842,55,55
1400000US26163558600,"Census Tract 5586, Wayne County, Michigan",737,648,7,610,31,89
1400000US26163559100,"Census Tract 5591, Wayne County, Michigan",941,847,0,796,51,94
1400000US26163560400,"Census Tract 5604, Wayne County, Michigan",2605,2411,0,2291,120,194
1400000US26163562400,"Census Tract 5624, Wayne County, Michigan",2007,1911,0,1872,39,96
1400000US26163562700,"Census Tract 5627, Wayne County, Michigan",1603,1498,0,1443,55,105
1400000US26163541400,"Census Tract 5414, Wayne County, Michigan",1189,1011,0,743,268,178
1400000US26163542700,"Census Tract 5427, Wayne County, Michigan",318,261,4,190,67,57
1400000US26163542800,"Census Tract 5428, Wayne County, Michigan",1000,872,0,747,125,128
1400000US26163543000,"Census Tract 5430, Wayne County, Michigan",694,665,8,615,42,29
1400000US26163544200,"Census Tract 5442, Wayne County, Michigan",839,678,0,447,231,161
1400000US26125196900,"Census Tract 1969, Oakland County, Michigan",1278,1246,5,1178,63,32
1400000US26125198100,"Census Tract 1981, Oakland County, Michigan",1507,1128,17,995,116,379
1400000US26125197600,"Census Tract 1976, Oakland County, Michigan",995,947,17,900,30,48
1400000US26125157600,"Census Tract 1576, Oakland County, Michigan",1754,1723,10,1687,26,31
1400000US26125166400,"Census Tract 1664, Oakland County, Michigan",1185,1157,0,1128,29,28
1400000US26125192800,"Census Tract 1928, Oakland County, Michigan",197,189,0,179,10,8
1400000US26125162100,"Census Tract 1621, Oakland County, Michigan",1729,1358,10,1082,266,371
1400000US26125171100,"Census Tract 1711, Oakland County, Michigan",1616,1560,6,1432,122,56
1400000US26125188100,"Census Tract 1881, Oakland County, Michigan",883,867,0,857,10,16
1400000US26125144900,"Census Tract 1449, Oakland County, Michigan",1922,1660,0,1436,224,262
1400000US26125150500,"Census Tract 1505, Oakland County, Michigan",1087,1003,29,964,10,84
1400000US26125156200,"Census Tract 1562, Oakland County, Michigan",2396,2344,0,2199,145,52
1400000US26125152000,"Census Tract 1520, Oakland County, Michigan",1313,1263,0,1231,32,50
1400000US26125180100,"Census Tract 1801, Oakland County, Michigan",1302,1212,17,1136,59,90
1400000US26125156500,"Census Tract 1565, Oakland County, Michigan",1635,1572,0,1538,34,63
1400000US26125166500,"Census Tract 1665, Oakland County, Michigan",998,977,10,893,74,21
1400000US26125168500,"Census Tract 1685, Oakland County, Michigan",1494,1231,0,1190,41,263
1400000US26125190800,"Census Tract 1908, Oakland County, Michigan",1359,1334,0,1241,93,25
1400000US26125196300,"Census Tract 1963, Oakland County, Michigan",1325,1284,16,1227,41,41
1400000US26125134500,"Census Tract 1345, Oakland County, Michigan",1174,1148,0,1102,46,26
1400000US26125122700,"Census Tract 1227, Oakland County, Michigan",1196,1166,0,1103,63,30
1400000US26125156000,"Census Tract 1560, Oakland County, Michigan",1129,1077,0,1033,44,52
1400000US26125134900,"Census Tract 1349, Oakland County, Michigan",1988,1713,0,1632,81,275
1400000US26125142000,"Census Tract 1420, Oakland County, Michigan",980,726,5,650,71,254
1400000US26125161500,"Census Tract 1615, Oakland County, Michigan",701,660,0,639,21,41
1400000US26125167400,"Census Tract 1674, Oakland County, Michigan",2202,2021,0,1557,464,181
1400000US26125173600,"Census Tract 1736, Oakland County, Michigan",755,713,0,656,57,42
1400000US26125121400,"Census Tract 1214, Oakland County, Michigan",1566,1523,11,1462,50,43
1400000US26125128700,"Census Tract 1287, Oakland County, Michigan",654,644,0,638,6,10
1400000US26125134700,"Census Tract 1347, Oakland County, Michigan",1566,1431,9,1343,79,135
1400000US26005030500,"Census Tract 305, Allegan County, Michigan",2803,2265,10,2020,235,538
1400000US26005031900,"Census Tract 319, Allegan County, Michigan",1836,1473,11,1341,121,363
1400000US26005032000,"Census Tract 320, Allegan County, Michigan",2064,1807,0,1581,226,257
1400000US26005032100,"Census Tract 321, Allegan County, Michigan",1745,1499,24,1368,107,246
1400000US26005031300,"Census Tract 313, Allegan County, Michigan",1877,1522,14,1317,191,355
1400000US26005030300,"Census Tract 303, Allegan County, Michigan",2685,2305,20,2042,243,380
1400000US26005030600,"Census Tract 306, Allegan County, Michigan",1798,1540,2,1264,274,258
1400000US26005030800,"Census Tract 308, Allegan County, Michigan",2242,1879,7,1763,109,363
1400000US26005031200,"Census Tract 312, Allegan County, Michigan",1856,1551,0,1363,188,305
1400000US26005031100,"Census Tract 311, Allegan County, Michigan",2729,2011,66,1764,181,718
1400000US26089970300,"Census Tract 9703, Leelanau County, Michigan",1152,1043,0,944,99,109
1400000US26089970600,"Census Tract 9706, Leelanau County, Michigan",2135,1932,0,1891,41,203
1400000US26087330000,"Census Tract 3300, Lapeer County, Michigan",1340,1121,23,941,157,219
1400000US26087333000,"Census Tract 3330, Lapeer County, Michigan",1212,1011,7,900,104,201
1400000US26087330500,"Census Tract 3305, Lapeer County, Michigan",1122,988,19,828,141,134
1400000US26163545700,"Census Tract 5457, Wayne County, Michigan",1132,891,3,777,111,241
1400000US26163546900,"Census Tract 5469, Wayne County, Michigan",436,409,0,333,76,27
1400000US26163550600,"Census Tract 5506, Wayne County, Michigan",828,805,0,786,19,23
1400000US26163550700,"Census Tract 5507, Wayne County, Michigan",1891,1798,0,1715,83,93
1400000US26163551200,"Census Tract 5512, Wayne County, Michigan",1514,1466,0,1386,80,48
1400000US26163553400,"Census Tract 5534, Wayne County, Michigan",1300,625,6,267,352,675
1400000US26147640200,"Census Tract 6402, St. Clair County, Michigan",899,863,7,781,75,36
1400000US26147643000,"Census Tract 6430, St. Clair County, Michigan",1653,1369,27,1260,82,284
1400000US26147652100,"Census Tract 6521, St. Clair County, Michigan",951,874,4,772,98,77
1400000US26147655100,"Census Tract 6551, St. Clair County, Michigan",1920,1627,27,1343,257,293
1400000US26147630400,"Census Tract 6304, St. Clair County, Michigan",2010,1827,0,1684,143,183
1400000US26147631100,"Census Tract 6311, St. Clair County, Michigan",641,558,0,503,55,83
1400000US26147649000,"Census Tract 6490, St. Clair County, Michigan",1768,1532,0,1427,105,236
1400000US26147651200,"Census Tract 6512, St. Clair County, Michigan",790,709,6,630,73,81
1400000US26159010900,"Census Tract 109, Van Buren County, Michigan",2749,2586,22,2347,217,163
1400000US26147650200,"Census Tract 6502, St. Clair County, Michigan",526,490,0,483,7,36
1400000US26159010200,"Census Tract 102, Van Buren County, Michigan",2345,1914,5,1536,373,431
1400000US26159010300,"Census Tract 103, Van Buren County, Michigan",1220,918,0,819,99,302
1400000US26159011002,"Census Tract 110.02, Van Buren County, Michigan",2553,2272,3,2129,140,281
1400000US26159010500,"Census Tract 105, Van Buren County, Michigan",1325,1148,19,1038,91,177
1400000US26159010100,"Census Tract 101, Van Buren County, Michigan",2701,2250,17,1871,362,451
1400000US26159011500,"Census Tract 115, Van Buren County, Michigan",1382,1238,18,985,235,144
1400000US26159010600,"Census Tract 106, Van Buren County, Michigan",1114,850,6,693,151,264
1400000US26159011300,"Census Tract 113, Van Buren County, Michigan",1553,1342,17,1091,234,211
1400000US26159011400,"Census Tract 114, Van Buren County, Michigan",1558,1226,17,1058,151,332
1400000US26159011600,"Census Tract 116, Van Buren County, Michigan",2436,2082,16,1734,332,354
1400000US26099260200,"Census Tract 2602, Macomb County, Michigan",888,789,0,749,40,99
1400000US26099260300,"Census Tract 2603, Macomb County, Michigan",1234,1123,8,1049,66,111
1400000US26099261100,"Census Tract 2611, Macomb County, Michigan",1989,1541,0,1446,95,448
1400000US26099262700,"Census Tract 2627, Macomb County, Michigan",2054,1805,0,1646,159,249
1400000US26099263500,"Census Tract 2635, Macomb County, Michigan",1717,1307,9,1169,129,410
1400000US26099230800,"Census Tract 2308, Macomb County, Michigan",1678,1524,0,1359,165,154
1400000US26099231600,"Census Tract 2316, Macomb County, Michigan",1984,1732,0,1700,32,252
1400000US26099231900,"Census Tract 2319, Macomb County, Michigan",2162,1930,19,1815,96,232
1400000US26099232100,"Census Tract 2321, Macomb County, Michigan",2784,2489,0,2354,135,295
1400000US26099232400,"Census Tract 2324, Macomb County, Michigan",2167,1936,0,1760,176,231
1400000US26099240000,"Census Tract 2400, Macomb County, Michigan",1735,1390,0,1145,245,345
1400000US26099240400,"Census Tract 2404, Macomb County, Michigan",2392,2080,14,1961,105,312
1400000US26099240900,"Census Tract 2409, Macomb County, Michigan",732,676,2,654,20,56
1400000US26099241600,"Census Tract 2416, Macomb County, Michigan",926,851,0,794,57,75
1400000US26099245300,"Census Tract 2453, Macomb County, Michigan",2073,1689,0,1562,127,384
1400000US26099245400,"Census Tract 2454, Macomb County, Michigan",628,524,0,447,77,104
1400000US26099247100,"Census Tract 2471, Macomb County, Michigan",438,301,0,265,36,137
1400000US26099247400,"Census Tract 2474, Macomb County, Michigan",1091,1004,0,969,35,87
1400000US26099250600,"Census Tract 2506, Macomb County, Michigan",1257,1068,0,985,83,189
1400000US26087340500,"Census Tract 3405, Lapeer County, Michigan",1076,967,4,871,92,109
1400000US26087334000,"Census Tract 3340, Lapeer County, Michigan",942,864,11,796,57,78
1400000US26087342000,"Census Tract 3420, Lapeer County, Michigan",1688,1628,31,1463,134,60
1400000US26087333500,"Census Tract 3335, Lapeer County, Michigan",2328,2120,0,1972,148,208
1400000US26087337500,"Census Tract 3375, Lapeer County, Michigan",1881,1491,0,1317,174,390
1400000US26087338000,"Census Tract 3380, Lapeer County, Michigan",1888,1725,7,1517,201,163
1400000US26087339500,"Census Tract 3395, Lapeer County, Michigan",1345,1157,0,915,242,188
1400000US26087336500,"Census Tract 3365, Lapeer County, Michigan",0,0,0,0,0,0
1400000US26087337000,"Census Tract 3370, Lapeer County, Michigan",1641,1409,18,1179,212,232
1400000US26087339000,"Census Tract 3390, Lapeer County, Michigan",1001,837,0,726,111,164
1400000US26087334500,"Census Tract 3345, Lapeer County, Michigan",828,754,0,657,97,74
1400000US26087331000,"Census Tract 3310, Lapeer County, Michigan",644,562,16,479,67,82
1400000US26087331500,"Census Tract 3315, Lapeer County, Michigan",1054,957,21,819,117,97
1400000US26087332000,"Census Tract 3320, Lapeer County, Michigan",1999,1821,85,1552,184,178
1400000US26087336000,"Census Tract 3360, Lapeer County, Michigan",2043,1823,0,1676,147,220
1400000US26087332500,"Census Tract 3325, Lapeer County, Michigan",1372,1224,18,1036,170,148
1400000US26087338500,"Census Tract 3385, Lapeer County, Michigan",1716,1365,0,1178,187,351
1400000US26087340000,"Census Tract 3400, Lapeer County, Michigan",1441,1374,16,1202,156,67
1400000US26087341000,"Census Tract 3410, Lapeer County, Michigan",1750,1619,8,1504,107,131
1400000US26087341500,"Census Tract 3415, Lapeer County, Michigan",1672,1535,3,1400,132,137
1400000US26099218000,"Census Tract 2180, Macomb County, Michigan",2222,1997,0,1812,185,225
1400000US26099225200,"Census Tract 2252, Macomb County, Michigan",2422,2307,30,2155,122,115
1400000US26099225300,"Census Tract 2253, Macomb County, Michigan",2071,1850,0,1786,64,221
1400000US26099226400,"Census Tract 2264, Macomb County, Michigan",808,795,7,767,21,13
1400000US26099228100,"Census Tract 2281, Macomb County, Michigan",690,561,4,499,58,129
1400000US26099231500,"Census Tract 2315, Macomb County, Michigan",1635,1547,0,1494,53,88
1400000US26099241300,"Census Tract 2413, Macomb County, Michigan",996,805,0,717,88,191
1400000US26099242000,"Census Tract 2420, Macomb County, Michigan",3239,2792,0,2608,184,447
1400000US26099245000,"Census Tract 2450, Macomb County, Michigan",1807,1239,0,1062,177,568
1400000US26099245200,"Census Tract 2452, Macomb County, Michigan",748,619,0,583,36,129
1400000US26099250300,"Census Tract 2503, Macomb County, Michigan",1509,1297,0,1249,48,212
1400000US26099250800,"Census Tract 2508, Macomb County, Michigan",1235,1071,0,1010,61,164
1400000US26099251500,"Census Tract 2515, Macomb County, Michigan",830,681,0,647,34,149
1400000US26099254500,"Census Tract 2545, Macomb County, Michigan",1738,1514,21,1384,109,224
1400000US26099255300,"Census Tract 2553, Macomb County, Michigan",1720,1537,0,1358,179,183
1400000US26099255600,"Census Tract 2556, Macomb County, Michigan",1368,1196,0,1080,116,172
1400000US26099256400,"Census Tract 2564, Macomb County, Michigan",569,527,0,466,61,42
1400000US26099256800,"Census Tract 2568, Macomb County, Michigan",645,559,0,550,9,86
1400000US26099258300,"Census Tract 2583, Macomb County, Michigan",1087,928,7,806,115,159
1400000US26099258600,"Census Tract 2586, Macomb County, Michigan",1735,1565,0,1453,112,170
1400000US26099221800,"Census Tract 2218, Macomb County, Michigan",1848,1781,9,1663,109,67
1400000US26099227000,"Census Tract 2270, Macomb County, Michigan",2737,2553,16,2447,90,184
1400000US26099244000,"Census Tract 2440, Macomb County, Michigan",942,837,0,825,12,105
1400000US26099256100,"Census Tract 2561, Macomb County, Michigan",1112,972,0,870,102,140
1400000US26099262300,"Census Tract 2623, Macomb County, Michigan",1811,1572,0,1496,76,239
1400000US26099252000,"Census Tract 2520, Macomb County, Michigan",1246,1103,0,1001,102,143
1400000US26099254000,"Census Tract 2540, Macomb County, Michigan",671,635,0,603,32,36
1400000US26099215000,"Census Tract 2150, Macomb County, Michigan",2054,1935,9,1841,85,119
1400000US26099224100,"Census Tract 2241, Macomb County, Michigan",2733,2672,0,2672,0,61
1400000US26099225600,"Census Tract 2256, Macomb County, Michigan",2027,1898,0,1763,135,129
1400000US26099225800,"Census Tract 2258, Macomb County, Michigan",2561,2390,4,2275,111,171
1400000US26099225900,"Census Tract 2259, Macomb County, Michigan",2035,1926,12,1795,119,109
1400000US26099230500,"Census Tract 2305, Macomb County, Michigan",1607,1437,35,1151,251,170
1400000US26099231700,"Census Tract 2317, Macomb County, Michigan",1992,1881,0,1764,117,111
1400000US26099240600,"Census Tract 2406, Macomb County, Michigan",3030,2878,0,2717,161,152
1400000US26099241400,"Census Tract 2414, Macomb County, Michigan",1340,1127,9,1059,59,213
1400000US26099247200,"Census Tract 2472, Macomb County, Michigan",2725,2495,15,2316,164,230
1400000US26099250200,"Census Tract 2502, Macomb County, Michigan",1196,1065,14,1008,43,131
1400000US26099250400,"Census Tract 2504, Macomb County, Michigan",637,562,7,539,16,75
1400000US26099251300,"Census Tract 2513, Macomb County, Michigan",981,871,0,835,36,110
1400000US26099255200,"Census Tract 2552, Macomb County, Michigan",1993,1443,0,1351,92,550
1400000US26099258500,"Census Tract 2585, Macomb County, Michigan",776,650,1,558,91,126
1400000US26099255900,"Census Tract 2559, Macomb County, Michigan",713,655,0,603,52,58
1400000US26099256000,"Census Tract 2560, Macomb County, Michigan",946,848,0,787,61,98
1400000US26099256300,"Census Tract 2563, Macomb County, Michigan",719,642,0,618,24,77
1400000US26099214500,"Census Tract 2145, Macomb County, Michigan",1596,1540,0,1402,138,56
1400000US26099258800,"Census Tract 2588, Macomb County, Michigan",1390,1242,0,1161,81,148
1400000US26099260700,"Census Tract 2607, Macomb County, Michigan",1181,1092,0,1009,83,89
1400000US26099260900,"Census Tract 2609, Macomb County, Michigan",1750,1484,0,1381,103,266
1400000US26099261200,"Census Tract 2612, Macomb County, Michigan",1131,1024,0,996,28,107
1400000US26099262200,"Census Tract 2622, Macomb County, Michigan",1723,1435,7,1346,82,288
1400000US26099263200,"Census Tract 2632, Macomb County, Michigan",1127,903,0,837,66,224
1400000US26099264000,"Census Tract 2640, Macomb County, Michigan",744,573,0,488,85,171
1400000US26099225100,"Census Tract 2251, Macomb County, Michigan",1250,1171,0,1113,58,79
1400000US26099221500,"Census Tract 2215, Macomb County, Michigan",450,411,0,391,20,39
1400000US26099224400,"Census Tract 2244, Macomb County, Michigan",1755,1716,6,1671,39,39
1400000US26099230400,"Census Tract 2304, Macomb County, Michigan",1489,1393,17,1310,66,96
1400000US26099230700,"Census Tract 2307, Macomb County, Michigan",1684,1610,7,1562,41,74
1400000US26099231000,"Census Tract 2310, Macomb County, Michigan",1554,1485,0,1407,78,69
1400000US26099231200,"Census Tract 2312, Macomb County, Michigan",1623,1303,0,1215,88,320
1400000US26065002800,"Census Tract 28, Ingham County, Michigan",1189,1026,8,907,111,163
1400000US26065003301,"Census Tract 33.01, Ingham County, Michigan",1194,1049,0,911,138,145
1400000US26065003400,"Census Tract 34, Ingham County, Michigan",1091,988,10,851,127,103
1400000US26065003700,"Census Tract 37, Ingham County, Michigan",2420,1875,16,1304,555,545
1400000US26065003901,"Census Tract 39.01, Ingham County, Michigan",815,750,8,651,91,65
1400000US26065004301,"Census Tract 43.01, Ingham County, Michigan",1876,1809,8,1669,132,67
1400000US26065006200,"Census Tract 62, Ingham County, Michigan",2105,1978,33,1743,202,127
1400000US26065004403,"Census Tract 44.03, Ingham County, Michigan",581,577,0,423,154,4
1400000US26065004600,"Census Tract 46, Ingham County, Michigan",1864,1744,0,1660,84,120
1400000US26065000100,"Census Tract 1, Ingham County, Michigan",773,667,0,487,180,106
1400000US26099247300,"Census Tract 2473, Macomb County, Michigan",2896,2654,0,2622,32,242
1400000US26099223900,"Census Tract 2239, Macomb County, Michigan",3135,3026,15,2915,96,109
1400000US26099241200,"Census Tract 2412, Macomb County, Michigan",2159,1953,16,1786,151,206
1400000US26099255100,"Census Tract 2551, Macomb County, Michigan",1366,1147,7,889,251,219
1400000US26099258200,"Census Tract 2582, Macomb County, Michigan",1075,964,0,866,98,111
1400000US26099210000,"Census Tract 2100, Macomb County, Michigan",1574,1455,0,1334,121,119
1400000US26099224300,"Census Tract 2243, Macomb County, Michigan",1620,1560,6,1500,54,60
1400000US26099230900,"Census Tract 2309, Macomb County, Michigan",2953,2728,0,2654,74,225
1400000US26099211000,"Census Tract 2110, Macomb County, Michigan",2171,1998,0,1851,147,173
1400000US26099242100,"Census Tract 2421, Macomb County, Michigan",1476,1221,10,1140,71,255
1400000US26099251900,"Census Tract 2519, Macomb County, Michigan",1267,1157,9,1021,127,110
1400000US26065004801,"Census Tract 48.01, Ingham County, Michigan",2113,1993,15,1862,116,120
1400000US26065004802,"Census Tract 48.02, Ingham County, Michigan",1285,1231,0,1174,57,54
1400000US26065005401,"Census Tract 54.01, Ingham County, Michigan",1547,1372,19,1224,129,175
1400000US26065005402,"Census Tract 54.02, Ingham County, Michigan",1934,1663,0,1434,229,271
1400000US26139023500,"Census Tract 235, Ottawa County, Michigan",1510,1453,8,1421,24,57
1400000US26139023600,"Census Tract 236, Ottawa County, Michigan",784,739,0,679,60,45
1400000US26139024600,"Census Tract 246, Ottawa County, Michigan",1705,1637,8,1584,45,68
1400000US26139024300,"Census Tract 243, Ottawa County, Michigan",1823,1717,9,1684,24,106
1400000US26139024400,"Census Tract 244, Ottawa County, Michigan",3345,3146,12,2700,434,199
1400000US26139024500,"Census Tract 245, Ottawa County, Michigan",1942,1918,0,1223,695,24
1400000US26139024900,"Census Tract 249, Ottawa County, Michigan",1747,1532,31,1250,251,215
1400000US26139025100,"Census Tract 251, Ottawa County, Michigan",2845,2484,13,2218,253,361
1400000US26139025200,"Census Tract 252, Ottawa County, Michigan",2171,1898,33,1736,129,273
1400000US26139025500,"Census Tract 255, Ottawa County, Michigan",1566,1306,8,1210,88,260
1400000US26139025700,"Census Tract 257, Ottawa County, Michigan",2306,1922,0,1801,121,384
1400000US26139025800,"Census Tract 258, Ottawa County, Michigan",2033,1719,0,1553,166,314
1400000US26139990000,"Census Tract 9900, Ottawa County, Michigan",0,0,0,0,0,0
1400000US26141990000,"Census Tract 9900, Presque Isle County, Michigan",0,0,0,0,0,0
1400000US26143971200,"Census Tract 9712, Roscommon County, Michigan",1348,1115,10,995,110,233
1400000US26147990000,"Census Tract 9900, St. Clair County, Michigan",0,0,0,0,0,0
1400000US26149041101,"Census Tract 411.01, St. Joseph County, Michigan",1706,1413,22,1161,230,293
1400000US26149041102,"Census Tract 411.02, St. Joseph County, Michigan",1231,1106,6,974,126,125
1400000US26151990000,"Census Tract 9900, Sanilac County, Michigan",0,0,0,0,0,0
1400000US26153000100,"Census Tract 1, Schoolcraft County, Michigan",985,809,28,655,126,176
1400000US26153000200,"Census Tract 2, Schoolcraft County, Michigan",1051,870,19,765,86,181
1400000US26153000300,"Census Tract 3, Schoolcraft County, Michigan",1315,1027,11,831,185,288
1400000US26153990000,"Census Tract 9900, Schoolcraft County, Michigan",0,0,0,0,0,0
1400000US26155031301,"Census Tract 313.01, Shiawassee County, Michigan",1590,1378,17,1224,137,212
1400000US26155031302,"Census Tract 313.02, Shiawassee County, Michigan",1589,1397,0,1183,214,192
1400000US26157000100,"Census Tract 1, Tuscola County, Michigan",1656,1387,4,1227,156,269
1400000US26157000200,"Census Tract 2, Tuscola County, Michigan",1320,1093,11,873,209,227
1400000US26157000300,"Census Tract 3, Tuscola County, Michigan",1340,1151,21,948,182,189
1400000US26157000400,"Census Tract 4, Tuscola County, Michigan",1394,1182,21,1002,159,212
1400000US26157000500,"Census Tract 5, Tuscola County, Michigan",2061,1697,21,1461,215,364
1400000US26065000400,"Census Tract 4, Ingham County, Michigan",1100,1006,0,851,155,94
1400000US26065002902,"Census Tract 29.02, Ingham County, Michigan",2089,2061,0,1872,189,28
1400000US26065003602,"Census Tract 36.02, Ingham County, Michigan",1345,1251,8,1046,197,94
1400000US26065005201,"Census Tract 52.01, Ingham County, Michigan",2285,2052,15,1769,268,233
1400000US26065004100,"Census Tract 41, Ingham County, Michigan",1323,1301,0,1201,100,22
1400000US26065004402,"Census Tract 44.02, Ingham County, Michigan",808,808,0,166,642,0
1400000US26065004500,"Census Tract 45, Ingham County, Michigan",1719,1667,0,1467,200,52
1400000US26065005303,"Census Tract 53.03, Ingham County, Michigan",1971,1597,0,1366,231,374
1400000US26065005501,"Census Tract 55.01, Ingham County, Michigan",2336,2126,13,1971,142,210
1400000US26065002300,"Census Tract 23, Ingham County, Michigan",1424,1342,17,1140,185,82
1400000US26065004302,"Census Tract 43.02, Ingham County, Michigan",1021,1006,0,788,218,15
1400000US26163562600,"Census Tract 5626, Wayne County, Michigan",1696,1567,0,1513,54,129
1400000US26163566700,"Census Tract 5667, Wayne County, Michigan",1432,1336,0,1128,208,96
1400000US26163571500,"Census Tract 5715, Wayne County, Michigan",1549,1339,0,1136,203,210
1400000US26163584700,"Census Tract 5847, Wayne County, Michigan",908,826,0,737,89,82
1400000US26163555500,"Census Tract 5555, Wayne County, Michigan",1134,967,10,774,183,167
1400000US26163563300,"Census Tract 5633, Wayne County, Michigan",1274,1201,0,1185,16,73
1400000US26163568000,"Census Tract 5680, Wayne County, Michigan",1103,811,0,735,76,292
1400000US26163593300,"Census Tract 5933, Wayne County, Michigan",1292,1204,0,1133,71,88
1400000US26163574700,"Census Tract 5747, Wayne County, Michigan",1572,1447,8,1378,61,125
1400000US26163583700,"Census Tract 5837, Wayne County, Michigan",1464,1193,0,1105,88,271
1400000US26163599100,"Census Tract 5991, Wayne County, Michigan",1626,1463,6,1278,179,163
1400000US26163534600,"Census Tract 5346, Wayne County, Michigan",662,467,0,306,161,195
1400000US26163537600,"Census Tract 5376, Wayne County, Michigan",1305,1108,56,694,358,197
1400000US26163587000,"Census Tract 5870, Wayne County, Michigan",1769,1527,8,1443,76,242
1400000US26163582000,"Census Tract 5820, Wayne County, Michigan",1544,1297,41,1099,157,247
1400000US26163536400,"Census Tract 5364, Wayne County, Michigan",882,668,29,444,195,214
1400000US26163540500,"Census Tract 5405, Wayne County, Michigan",1335,1238,10,799,429,97
1400000US26163500700,"Census Tract 5007, Wayne County, Michigan",1402,1141,0,774,367,261
1400000US26163576400,"Census Tract 5764, Wayne County, Michigan",1401,1220,0,1078,142,181
1400000US26163578600,"Census Tract 5786, Wayne County, Michigan",2036,1584,0,1063,521,452
1400000US26163584400,"Census Tract 5844, Wayne County, Michigan",1264,1160,0,972,188,104
1400000US26163592000,"Census Tract 5920, Wayne County, Michigan",1402,1360,6,1296,58,42
1400000US26163540800,"Census Tract 5408, Wayne County, Michigan",890,660,0,575,85,230
1400000US26163558000,"Census Tract 5580, Wayne County, Michigan",1677,1605,18,1537,50,72
1400000US26163561700,"Census Tract 5617, Wayne County, Michigan",855,805,0,719,86,50
1400000US26163503900,"Census Tract 5039, Wayne County, Michigan",613,488,0,385,103,125
1400000US26163540400,"Census Tract 5404, Wayne County, Michigan",1136,964,6,732,226,172
1400000US26163568400,"Census Tract 5684, Wayne County, Michigan",1447,1262,0,1168,94,185
1400000US26163524300,"Census Tract 5243, Wayne County, Michigan",863,554,0,416,138,309
1400000US26163584200,"Census Tract 5842, Wayne County, Michigan",1276,1076,7,881,188,200
1400000US26163503600,"Census Tract 5036, Wayne County, Michigan",633,551,0,446,105,82
1400000US26163506100,"Census Tract 5061, Wayne County, Michigan",729,544,0,393,151,185
1400000US26163531400,"Census Tract 5314, Wayne County, Michigan",570,352,5,216,131,218
1400000US26163536300,"Census Tract 5363, Wayne County, Michigan",766,501,0,363,138,265
1400000US26157000600,"Census Tract 6, Tuscola County, Michigan",1891,1491,0,1280,211,400
1400000US26157000700,"Census Tract 7, Tuscola County, Michigan",1246,1085,21,880,184,161
1400000US26157000800,"Census Tract 8, Tuscola County, Michigan",1687,1451,4,1169,278,236
1400000US26157000900,"Census Tract 9, Tuscola County, Michigan",2086,1710,18,1408,284,376
1400000US26157001000,"Census Tract 10, Tuscola County, Michigan",2103,1826,60,1543,223,277
1400000US26157001100,"Census Tract 11, Tuscola County, Michigan",1322,1124,13,899,212,198
1400000US26157001200,"Census Tract 12, Tuscola County, Michigan",1814,1620,23,1362,235,194
1400000US26157001300,"Census Tract 13, Tuscola County, Michigan",1839,1621,16,1399,206,218
1400000US26065006001,"Census Tract 60.01, Ingham County, Michigan",1257,1132,7,933,192,125
1400000US26065006002,"Census Tract 60.02, Ingham County, Michigan",1437,1270,12,1076,182,167
1400000US26065006301,"Census Tract 63.01, Ingham County, Michigan",1714,1604,21,1405,178,110
1400000US26065006302,"Census Tract 63.02, Ingham County, Michigan",1718,1615,15,1463,137,103
1400000US26065006401,"Census Tract 64.01, Ingham County, Michigan",1488,1389,7,1270,112,99
1400000US26065006402,"Census Tract 64.02, Ingham County, Michigan",1099,988,18,842,128,111
1400000US26065006600,"Census Tract 66, Ingham County, Michigan",1408,1226,0,998,228,182
1400000US26065006700,"Census Tract 67, Ingham County, Michigan",2080,1757,10,1406,341,323
1400000US26065006800,"Census Tract 68, Ingham County, Michigan",1341,1101,13,722,366,240
1400000US26065007000,"Census Tract 70, Ingham County, Michigan",2592,2304,0,2153,151,288
1400000US26065980000,"Census Tract 9800, Ingham County, Michigan",4,4,0,4,0,0
1400000US26067031900,"Census Tract 319, Ionia County, Michigan",2338,2112,26,1711,375,226
1400000US26065980100,"Census Tract 9801, Ingham County, Michigan",2,2,0,2,0,0
1400000US26065980200,"Census Tract 9802, Ingham County, Michigan",0,0,0,0,0,0
1400000US26065980300,"Census Tract 9803, Ingham County, Michigan",0,0,0,0,0,0
1400000US26067032100,"Census Tract 321, Ionia County, Michigan",674,595,0,496,99,79
1400000US26067982200,"Census Tract 9822, Ionia County, Michigan",0,0,0,0,0,0
1400000US26069000100,"Census Tract 1, Iosco County, Michigan",1201,1015,27,879,109,186
1400000US26069000200,"Census Tract 2, Iosco County, Michigan",1782,1488,37,1331,120,294
1400000US26069000300,"Census Tract 3, Iosco County, Michigan",1196,1053,8,945,100,143
1400000US26069000400,"Census Tract 4, Iosco County, Michigan",1592,1347,15,1279,53,245
1400000US26069000500,"Census Tract 5, Iosco County, Michigan",1708,1433,6,1331,96,275
1400000US26069000600,"Census Tract 6, Iosco County, Michigan",1188,987,5,824,158,201
1400000US26069000700,"Census Tract 7, Iosco County, Michigan",1175,946,10,812,124,229
1400000US26069000800,"Census Tract 8, Iosco County, Michigan",857,664,15,603,46,193
1400000US26069000900,"Census Tract 9, Iosco County, Michigan",932,716,24,631,61,216
1400000US26069990000,"Census Tract 9900, Iosco County, Michigan",0,0,0,0,0,0
1400000US26071000100,"Census Tract 1, Iron County, Michigan",1073,892,19,695,178,181
1400000US26071000200,"Census Tract 2, Iron County, Michigan",741,606,15,476,115,135
1400000US26071000300,"Census Tract 3, Iron County, Michigan",1316,1058,16,772,270,258
1400000US26071000400,"Census Tract 4, Iron County, Michigan",1116,854,2,672,180,262
1400000US26071000500,"Census Tract 5, Iron County, Michigan",1081,820,16,633,171,261
1400000US26073000100,"Census Tract 1, Isabella County, Michigan",1355,1142,11,953,178,213
1400000US26073000200,"Census Tract 2, Isabella County, Michigan",1890,1683,28,1422,233,207
1400000US26073000300,"Census Tract 3, Isabella County, Michigan",1789,1527,28,1217,282,262
1400000US26073000400,"Census Tract 4, Isabella County, Michigan",1429,1368,0,1075,293,61
1400000US26073000500,"Census Tract 5, Isabella County, Michigan",919,909,0,641,268,10
1400000US26073000600,"Census Tract 6, Isabella County, Michigan",1986,1844,0,1576,268,142
1400000US26025002900,"Census Tract 29, Calhoun County, Michigan",1290,1080,22,915,143,210
1400000US26025003300,"Census Tract 33, Calhoun County, Michigan",851,620,4,524,92,231
1400000US26025003800,"Census Tract 38, Calhoun County, Michigan",1547,1367,7,1228,132,180
1400000US26025000200,"Census Tract 2, Calhoun County, Michigan",1317,1112,6,980,126,205
1400000US26025000600,"Census Tract 6, Calhoun County, Michigan",1024,798,0,682,116,226
1400000US26025001600,"Census Tract 16, Calhoun County, Michigan",1105,1006,10,949,47,99
1400000US26025002100,"Census Tract 21, Calhoun County, Michigan",496,372,0,313,59,124
1400000US26025001700,"Census Tract 17, Calhoun County, Michigan",1751,1620,47,1474,99,131
1400000US26025002800,"Census Tract 28, Calhoun County, Michigan",1563,1353,26,1136,191,210
1400000US26025002500,"Census Tract 25, Calhoun County, Michigan",1518,1350,10,1199,141,168
1400000US26025002600,"Census Tract 26, Calhoun County, Michigan",861,674,0,551,123,187
1400000US26025002700,"Census Tract 27, Calhoun County, Michigan",2402,2175,12,1882,281,227
1400000US26025003900,"Census Tract 39, Calhoun County, Michigan",1996,1764,12,1588,164,232
1400000US26025000900,"Census Tract 9, Calhoun County, Michigan",1502,1204,0,1054,150,298
1400000US26025001000,"Census Tract 10, Calhoun County, Michigan",1696,1324,11,1174,139,372
1400000US26025001200,"Census Tract 12, Calhoun County, Michigan",1090,988,0,875,113,102
1400000US26025001400,"Census Tract 14, Calhoun County, Michigan",1705,1355,0,1146,209,350
1400000US26025001500,"Census Tract 15, Calhoun County, Michigan",2101,1857,12,1719,126,244
1400000US26025003600,"Census Tract 36, Calhoun County, Michigan",922,564,0,404,160,358
1400000US26025001800,"Census Tract 18, Calhoun County, Michigan",2802,2535,0,2405,130,267
1400000US26025002000,"Census Tract 20, Calhoun County, Michigan",2201,1995,18,1824,153,206
1400000US26025003200,"Census Tract 32, Calhoun County, Michigan",848,708,21,624,63,140
1400000US26025004000,"Census Tract 40, Calhoun County, Michigan",1941,1614,0,1432,182,327
1400000US26025003000,"Census Tract 30, Calhoun County, Michigan",810,659,3,509,147,151
1400000US26055550101,"Census Tract 5501.01, Grand Traverse County, Michigan",2394,2307,0,2195,112,87
1400000US26055550102,"Census Tract 5501.02, Grand Traverse County, Michigan",1528,1350,0,1250,100,178
1400000US26055550200,"Census Tract 5502, Grand Traverse County, Michigan",1667,1567,18,1413,136,100
1400000US26055550300,"Census Tract 5503, Grand Traverse County, Michigan",2265,2076,2,1859,215,189
1400000US26055550400,"Census Tract 5504, Grand Traverse County, Michigan",2444,2313,4,2181,128,131
1400000US26055550500,"Census Tract 5505, Grand Traverse County, Michigan",2325,2202,0,1957,245,123
1400000US26055550600,"Census Tract 5506, Grand Traverse County, Michigan",3619,3307,28,2995,284,312
1400000US26055550700,"Census Tract 5507, Grand Traverse County, Michigan",3848,3362,0,3028,334,486
1400000US26055550800,"Census Tract 5508, Grand Traverse County, Michigan",2500,2374,0,2269,105,126
1400000US26055550900,"Census Tract 5509, Grand Traverse County, Michigan",2227,2145,40,2056,49,82
1400000US26055551000,"Census Tract 5510, Grand Traverse County, Michigan",1912,1832,28,1688,116,80
1400000US26055551100,"Census Tract 5511, Grand Traverse County, Michigan",1518,1352,0,1244,108,166
1400000US26055551200,"Census Tract 5512, Grand Traverse County, Michigan",1651,1435,0,1356,79,216
1400000US26125197701,"Census Tract 1977.01, Oakland County, Michigan",2195,2116,15,2022,79,79
1400000US26125197702,"Census Tract 1977.02, Oakland County, Michigan",1037,1007,0,949,58,30
1400000US26125981000,"Census Tract 9810, Oakland County, Michigan",0,0,0,0,0,0
1400000US26127010600,"Census Tract 106, Oceana County, Michigan",2060,1678,12,1244,422,382
1400000US26127010800,"Census Tract 108, Oceana County, Michigan",1225,1121,9,937,175,104
1400000US26127010900,"Census Tract 109, Oceana County, Michigan",1024,874,12,730,132,150
1400000US26127011000,"Census Tract 110, Oceana County, Michigan",692,613,6,501,106,79
1400000US26127990000,"Census Tract 9900, Oceana County, Michigan",0,0,0,0,0,0
1400000US26129950900,"Census Tract 9509, Ogemaw County, Michigan",1754,1476,13,1290,173,278
1400000US26131990100,"Census Tract 9901, Ontonagon County, Michigan",0,0,0,0,0,0
1400000US26135970201,"Census Tract 9702.01, Oscoda County, Michigan",722,546,50,453,43,176
1400000US26135970202,"Census Tract 9702.02, Oscoda County, Michigan",726,610,9,525,76,116
1400000US26139020501,"Census Tract 205.01, Ottawa County, Michigan",1300,1179,0,1148,31,121
1400000US26139020503,"Census Tract 205.03, Ottawa County, Michigan",1408,1342,9,1293,40,66
1400000US26139020504,"Census Tract 205.04, Ottawa County, Michigan",1303,1163,0,1087,76,140
1400000US26139021201,"Census Tract 212.01, Ottawa County, Michigan",1829,1747,11,1671,65,82
1400000US26139021202,"Census Tract 212.02, Ottawa County, Michigan",3065,2793,31,2540,222,272
1400000US26139021301,"Census Tract 213.01, Ottawa County, Michigan",1141,1070,0,966,104,71
1400000US26139021303,"Census Tract 213.03, Ottawa County, Michigan",888,877,0,790,87,11
1400000US26139021304,"Census Tract 213.04, Ottawa County, Michigan",2000,1946,15,1872,59,54
1400000US26139021605,"Census Tract 216.05, Ottawa County, Michigan",1355,1308,0,1265,43,47
1400000US26139021606,"Census Tract 216.06, Ottawa County, Michigan",2441,1854,0,1674,180,587
1400000US26139021801,"Census Tract 218.01, Ottawa County, Michigan",1788,1581,22,1427,132,207
1400000US26139021802,"Census Tract 218.02, Ottawa County, Michigan",1580,1510,0,1493,17,70
1400000US26139021901,"Census Tract 219.01, Ottawa County, Michigan",1633,1459,18,1346,95,174
1400000US26139022103,"Census Tract 221.03, Ottawa County, Michigan",604,568,0,546,22,36
1400000US26139021902,"Census Tract 219.02, Ottawa County, Michigan",2669,2483,18,2317,148,186
1400000US26139022001,"Census Tract 220.01, Ottawa County, Michigan",1905,1812,0,1592,220,93
1400000US26139022002,"Census Tract 220.02, Ottawa County, Michigan",1701,1584,0,1505,79,117
1400000US26139022105,"Census Tract 221.05, Ottawa County, Michigan",2121,1970,0,1890,80,151
1400000US26139022106,"Census Tract 221.06, Ottawa County, Michigan",1306,1259,10,1220,29,47
1400000US26139022107,"Census Tract 221.07, Ottawa County, Michigan",605,583,0,568,15,22
1400000US26139022108,"Census Tract 221.08, Ottawa County, Michigan",2455,2309,0,2181,128,146
1400000US26139022203,"Census Tract 222.03, Ottawa County, Michigan",3462,3125,7,2957,161,337
1400000US26139022206,"Census Tract 222.06, Ottawa County, Michigan",1730,1602,18,1489,95,128
1400000US26139023001,"Census Tract 230.01, Ottawa County, Michigan",1990,1936,29,1833,74,54
1400000US26139023002,"Census Tract 230.02, Ottawa County, Michigan",2342,2105,14,1937,154,237
1400000US26055551300,"Census Tract 5513, Grand Traverse County, Michigan",3702,3231,0,2799,432,471
1400000US26055551400,"Census Tract 5514, Grand Traverse County, Michigan",2189,1859,13,1642,204,330
1400000US26055551500,"Census Tract 5515, Grand Traverse County, Michigan",1345,1227,23,1126,78,118
1400000US26055990000,"Census Tract 9900, Grand Traverse County, Michigan",0,0,0,0,0,0
1400000US26057000100,"Census Tract 1, Gratiot County, Michigan",1616,1340,13,1103,224,276
1400000US26057000200,"Census Tract 2, Gratiot County, Michigan",2055,1681,18,1457,206,374
1400000US26057000300,"Census Tract 3, Gratiot County, Michigan",1631,1318,5,1077,236,313
1400000US26057000400,"Census Tract 4, Gratiot County, Michigan",0,0,0,0,0,0
1400000US26057000500,"Census Tract 5, Gratiot County, Michigan",2091,1692,16,1290,386,399
1400000US26057000600,"Census Tract 6, Gratiot County, Michigan",1696,1535,7,1260,268,161
1400000US26057000700,"Census Tract 7, Gratiot County, Michigan",1385,1203,21,888,294,182
1400000US26057000800,"Census Tract 8, Gratiot County, Michigan",1723,1407,14,1109,284,316
1400000US26057000900,"Census Tract 9, Gratiot County, Michigan",1430,1185,22,889,274,245
1400000US26057001000,"Census Tract 10, Gratiot County, Michigan",1550,1330,0,1130,200,220
1400000US26061000100,"Census Tract 1, Houghton County, Michigan",957,822,8,745,69,135
1400000US26061000200,"Census Tract 2, Houghton County, Michigan",1194,949,4,856,89,245
1400000US26061000300,"Census Tract 3, Houghton County, Michigan",958,664,4,606,54,294
1400000US26061000400,"Census Tract 4, Houghton County, Michigan",1271,1094,6,1003,85,177
1400000US26061000500,"Census Tract 5, Houghton County, Michigan",1298,1117,0,983,134,181
1400000US26061000600,"Census Tract 6, Houghton County, Michigan",1585,1372,0,1200,172,213
1400000US26061000700,"Census Tract 7, Houghton County, Michigan",1129,983,6,832,145,146
1400000US26061000800,"Census Tract 8, Houghton County, Michigan",1949,1756,11,1555,190,193
1400000US26061000900,"Census Tract 9, Houghton County, Michigan",1869,1657,7,1519,131,212
1400000US26061001000,"Census Tract 10, Houghton County, Michigan",1130,976,10,899,67,154
1400000US26061990000,"Census Tract 9900, Houghton County, Michigan",0,0,0,0,0,0
1400000US26063990000,"Census Tract 9900, Huron County, Michigan",0,0,0,0,0,0
1400000US26065001703,"Census Tract 17.03, Ingham County, Michigan",2081,1731,27,1494,210,350
1400000US26065002101,"Census Tract 21.01, Ingham County, Michigan",793,680,3,508,169,113
1400000US26065003103,"Census Tract 31.03, Ingham County, Michigan",2791,2572,24,2325,223,219
1400000US26065004490,"Census Tract 44.90, Ingham County, Michigan",0,0,0,0,0,0
1400000US26065004491,"Census Tract 44.91, Ingham County, Michigan",0,0,0,0,0,0
1400000US26065004492,"Census Tract 44.92, Ingham County, Michigan",0,0,0,0,0,0
1400000US26065004493,"Census Tract 44.93, Ingham County, Michigan",0,0,0,0,0,0
1400000US26163540300,"Census Tract 5403, Wayne County, Michigan",1547,1312,29,977,306,235
1400000US26065004494,"Census Tract 44.94, Ingham County, Michigan",0,0,0,0,0,0
1400000US26163539300,"Census Tract 5393, Wayne County, Michigan",1654,1385,0,1153,232,269
1400000US26163539500,"Census Tract 5395, Wayne County, Michigan",1215,904,0,753,151,311
1400000US26163540700,"Census Tract 5407, Wayne County, Michigan",1123,997,0,765,232,126
1400000US26163540900,"Census Tract 5409, Wayne County, Michigan",1373,1146,0,774,372,227
1400000US26163542600,"Census Tract 5426, Wayne County, Michigan",1275,1007,0,701,306,268
1400000US26163510600,"Census Tract 5106, Wayne County, Michigan",1512,1302,13,987,302,210
1400000US26163510700,"Census Tract 5107, Wayne County, Michigan",485,363,0,310,53,122
1400000US26163512200,"Census Tract 5122, Wayne County, Michigan",396,297,0,184,113,99
1400000US26163512400,"Census Tract 5124, Wayne County, Michigan",466,303,0,224,79,163
1400000US26163538500,"Census Tract 5385, Wayne County, Michigan",1787,1513,0,1234,279,274
1400000US26163539000,"Census Tract 5390, Wayne County, Michigan",1029,845,0,705,140,184
1400000US26163539700,"Census Tract 5397, Wayne County, Michigan",933,754,0,471,283,179
1400000US26163565300,"Census Tract 5653, Wayne County, Michigan",2615,2369,0,1939,430,246
1400000US26163581900,"Census Tract 5819, Wayne County, Michigan",1701,1540,0,1425,115,161
1400000US26163583000,"Census Tract 5830, Wayne County, Michigan",949,818,13,700,105,131
1400000US26163583900,"Census Tract 5839, Wayne County, Michigan",1660,1481,42,1244,195,179
1400000US26163500200,"Census Tract 5002, Wayne County, Michigan",1034,916,12,699,205,118
1400000US26163500300,"Census Tract 5003, Wayne County, Michigan",745,646,0,527,119,99
1400000US26163500500,"Census Tract 5005, Wayne County, Michigan",613,518,0,361,157,95
1400000US26163501100,"Census Tract 5011, Wayne County, Michigan",1069,809,0,432,377,260
1400000US26163501300,"Census Tract 5013, Wayne County, Michigan",1078,918,0,592,326,160
1400000US26163560100,"Census Tract 5601, Wayne County, Michigan",1152,1031,0,979,52,121
1400000US26163562800,"Census Tract 5628, Wayne County, Michigan",1457,1362,0,1301,61,95
1400000US26163563400,"Census Tract 5634, Wayne County, Michigan",1843,1754,0,1658,96,89
1400000US26163564200,"Census Tract 5642, Wayne County, Michigan",1535,1375,16,1298,61,160
1400000US26163564700,"Census Tract 5647, Wayne County, Michigan",1724,1694,0,1581,113,30
1400000US26163565000,"Census Tract 5650, Wayne County, Michigan",1770,1686,17,1635,34,84
1400000US26163565700,"Census Tract 5657, Wayne County, Michigan",1257,1233,0,1184,49,24
1400000US26163565800,"Census Tract 5658, Wayne County, Michigan",1626,1371,0,1194,177,255
1400000US26163566400,"Census Tract 5664, Wayne County, Michigan",447,390,8,332,50,57
1400000US26163567800,"Census Tract 5678, Wayne County, Michigan",2315,1974,0,1635,339,341
1400000US26163569400,"Census Tract 5694, Wayne County, Michigan",1136,883,0,764,119,253
1400000US26163571600,"Census Tract 5716, Wayne County, Michigan",665,499,5,445,49,166
1400000US26163573100,"Census Tract 5731, Wayne County, Michigan",1492,1396,20,1253,123,96
1400000US26163573300,"Census Tract 5733, Wayne County, Michigan",1012,934,10,713,211,78
1400000US26163573600,"Census Tract 5736, Wayne County, Michigan",1739,1530,6,1147,377,209
1400000US26163573800,"Census Tract 5738, Wayne County, Michigan",1284,1167,0,951,216,117
1400000US26163573900,"Census Tract 5739, Wayne County, Michigan",1292,1103,7,856,240,189
1400000US26163574300,"Census Tract 5743, Wayne County, Michigan",1064,1034,0,881,153,30
1400000US26163574800,"Census Tract 5748, Wayne County, Michigan",1396,1369,8,1289,72,27
1400000US26163575300,"Census Tract 5753, Wayne County, Michigan",1331,1272,0,1144,128,59
1400000US26163576500,"Census Tract 5765, Wayne County, Michigan",1464,1358,0,1325,33,106
1400000US26163576600,"Census Tract 5766, Wayne County, Michigan",1552,1445,23,1245,177,107
1400000US26163577200,"Census Tract 5772, Wayne County, Michigan",1145,894,0,779,115,251
1400000US26125140700,"Census Tract 1407, Oakland County, Michigan",1042,1007,0,892,115,35
1400000US26163577700,"Census Tract 5777, Wayne County, Michigan",847,755,0,691,64,92
1400000US26163580200,"Census Tract 5802, Wayne County, Michigan",1221,1053,9,953,91,168
1400000US26163583100,"Census Tract 5831, Wayne County, Michigan",1359,1205,0,974,231,154
1400000US26125142200,"Census Tract 1422, Oakland County, Michigan",1104,871,0,631,240,233
1400000US26125142600,"Census Tract 1426, Oakland County, Michigan",1614,1413,0,1285,128,201
1400000US26081013700,"Census Tract 137, Kent County, Michigan",2510,2236,17,2124,95,274
1400000US26081014000,"Census Tract 140, Kent County, Michigan",2706,2315,12,2201,102,391
1400000US26081014703,"Census Tract 147.03, Kent County, Michigan",1733,1621,22,1452,147,112
1400000US26081014806,"Census Tract 148.06, Kent County, Michigan",1949,1856,6,1761,89,93
1400000US26059050500,"Census Tract 505, Hillsdale County, Michigan",1705,1430,3,1301,126,275
1400000US26059051000,"Census Tract 510, Hillsdale County, Michigan",1675,1305,13,1077,215,370
1400000US26059050600,"Census Tract 506, Hillsdale County, Michigan",1460,1183,25,945,213,277
1400000US26059050700,"Census Tract 507, Hillsdale County, Michigan",1799,1374,21,1185,168,425
1400000US26059051200,"Census Tract 512, Hillsdale County, Michigan",1178,852,15,716,121,326
1400000US26059051100,"Census Tract 511, Hillsdale County, Michigan",1436,1122,7,977,138,314
1400000US26059050100,"Census Tract 501, Hillsdale County, Michigan",1968,1763,15,1585,163,205
1400000US26059050300,"Census Tract 503, Hillsdale County, Michigan",938,773,9,625,139,165
1400000US26125144400,"Census Tract 1444, Oakland County, Michigan",1855,1615,27,1497,91,240
1400000US26125153300,"Census Tract 1533, Oakland County, Michigan",1465,1465,8,1428,29,0
1400000US26125154000,"Census Tract 1540, Oakland County, Michigan",838,818,0,792,26,20
1400000US26125156900,"Census Tract 1569, Oakland County, Michigan",1118,1098,0,1068,30,20
1400000US26125157100,"Census Tract 1571, Oakland County, Michigan",720,686,0,657,29,34
1400000US26125160500,"Census Tract 1605, Oakland County, Michigan",1590,1325,0,1292,33,265
1400000US26125161800,"Census Tract 1618, Oakland County, Michigan",1735,1640,0,1491,149,95
1400000US26125162500,"Census Tract 1625, Oakland County, Michigan",1505,1353,15,1172,166,152
1400000US26125166800,"Census Tract 1668, Oakland County, Michigan",1226,1053,0,1005,48,173
1400000US26125166900,"Census Tract 1669, Oakland County, Michigan",1314,1208,0,1175,33,106
1400000US26125167300,"Census Tract 1673, Oakland County, Michigan",1525,1366,0,1196,170,159
1400000US26125168100,"Census Tract 1681, Oakland County, Michigan",820,803,0,778,25,17
1400000US26125171200,"Census Tract 1712, Oakland County, Michigan",962,918,0,840,78,44
1400000US26125172400,"Census Tract 1724, Oakland County, Michigan",1082,878,0,693,185,204
1400000US26125173200,"Census Tract 1732, Oakland County, Michigan",1373,1250,0,1229,21,123
1400000US26125180000,"Census Tract 1800, Oakland County, Michigan",1187,1085,0,988,97,102
1400000US26125183400,"Census Tract 1834, Oakland County, Michigan",1209,1166,0,1103,63,43
1400000US26125184000,"Census Tract 1840, Oakland County, Michigan",1292,1263,0,1169,94,29
1400000US26125184300,"Census Tract 1843, Oakland County, Michigan",1325,1280,0,1228,52,45
1400000US26125190200,"Census Tract 1902, Oakland County, Michigan",1356,1328,10,1273,45,28
1400000US26125193000,"Census Tract 1930, Oakland County, Michigan",1248,1212,0,1203,9,36
1400000US26125194100,"Census Tract 1941, Oakland County, Michigan",1062,998,0,948,50,64
1400000US26125194600,"Census Tract 1946, Oakland County, Michigan",1632,1585,0,1568,17,47
1400000US26125196000,"Census Tract 1960, Oakland County, Michigan",2010,1936,15,1912,9,74
1400000US26125196500,"Census Tract 1965, Oakland County, Michigan",1951,1885,0,1841,44,66
1400000US26125197300,"Census Tract 1973, Oakland County, Michigan",1830,1696,0,1615,81,134
1400000US26125157300,"Census Tract 1573, Oakland County, Michigan",1363,1267,0,1235,32,96
1400000US26125161000,"Census Tract 1610, Oakland County, Michigan",974,796,0,713,83,178
1400000US26125181600,"Census Tract 1816, Oakland County, Michigan",2287,2032,0,1893,139,255
1400000US26125161300,"Census Tract 1613, Oakland County, Michigan",1420,1294,0,1277,17,126
1400000US26125162200,"Census Tract 1622, Oakland County, Michigan",693,642,20,553,69,51
1400000US26125165200,"Census Tract 1652, Oakland County, Michigan",1563,1506,8,1405,93,57
1400000US26115830100,"Census Tract 8301, Monroe County, Michigan",1379,1249,14,1210,25,130
1400000US26115830200,"Census Tract 8302, Monroe County, Michigan",2149,2002,61,1763,178,147
1400000US26115830400,"Census Tract 8304, Monroe County, Michigan",1635,1427,0,1301,126,208
1400000US26115831500,"Census Tract 8315, Monroe County, Michigan",1394,1071,0,973,98,323
1400000US26115831800,"Census Tract 8318, Monroe County, Michigan",417,335,0,190,145,82
1400000US26115831300,"Census Tract 8313, Monroe County, Michigan",1974,1840,0,1680,160,134
1400000US26115831400,"Census Tract 8314, Monroe County, Michigan",3120,2730,15,2470,245,390
1400000US26115832800,"Census Tract 8328, Monroe County, Michigan",1775,1666,20,1403,243,109
1400000US26115831100,"Census Tract 8311, Monroe County, Michigan",986,861,17,762,82,125
1400000US26115831200,"Census Tract 8312, Monroe County, Michigan",2613,2364,14,2010,340,249
1400000US26115832300,"Census Tract 8323, Monroe County, Michigan",1803,1477,8,1211,258,326
1400000US26115833000,"Census Tract 8330, Monroe County, Michigan",1741,1582,56,1356,170,159
1400000US26115830600,"Census Tract 8306, Monroe County, Michigan",1081,945,20,785,140,136
1400000US26115830800,"Census Tract 8308, Monroe County, Michigan",2949,2591,0,2344,247,358
1400000US26115831900,"Census Tract 8319, Monroe County, Michigan",540,508,0,413,95,32
1400000US26115832200,"Census Tract 8322, Monroe County, Michigan",721,555,0,513,42,166
1400000US26115832500,"Census Tract 8325, Monroe County, Michigan",1959,1686,0,1556,130,273
1400000US26115832700,"Census Tract 8327, Monroe County, Michigan",984,899,18,835,46,85
1400000US26115832900,"Census Tract 8329, Monroe County, Michigan",1595,1427,0,1249,178,168
1400000US26115833300,"Census Tract 8333, Monroe County, Michigan",2708,2312,0,2188,124,396
1400000US26115830900,"Census Tract 8309, Monroe County, Michigan",939,838,6,782,50,101
1400000US26115831600,"Census Tract 8316, Monroe County, Michigan",1451,1180,12,1014,154,271
1400000US26115831700,"Census Tract 8317, Monroe County, Michigan",1437,1304,17,1213,74,133
1400000US26115832000,"Census Tract 8320, Monroe County, Michigan",663,624,0,531,93,39
1400000US26115832400,"Census Tract 8324, Monroe County, Michigan",1848,1582,10,1455,117,266
1400000US26115833200,"Census Tract 8332, Monroe County, Michigan",1464,1327,0,1222,105,137
1400000US26115833500,"Census Tract 8335, Monroe County, Michigan",2090,1733,44,1495,194,357
1400000US26115830700,"Census Tract 8307, Monroe County, Michigan",1446,1323,1,1200,122,123
1400000US26115833900,"Census Tract 8339, Monroe County, Michigan",2006,1834,0,1784,50,172
1400000US26115833100,"Census Tract 8331, Monroe County, Michigan",1997,1805,0,1657,148,192
1400000US26005030402,"Census Tract 304.02, Allegan County, Michigan",1779,1662,16,1599,47,117
1400000US26005030702,"Census Tract 307.02, Allegan County, Michigan",1754,1550,6,1347,197,204
1400000US26005031000,"Census Tract 310, Allegan County, Michigan",2168,1627,0,1347,280,541
1400000US26005031800,"Census Tract 318, Allegan County, Michigan",1876,1566,0,1361,205,310
1400000US26005030401,"Census Tract 304.01, Allegan County, Michigan",2605,2340,0,2225,115,265
1400000US26163513600,"Census Tract 5136, Wayne County, Michigan",437,278,0,241,37,159
1400000US26081001600,"Census Tract 16, Kent County, Michigan",1939,1698,0,1489,209,241
1400000US26081001800,"Census Tract 18, Kent County, Michigan",2988,2441,27,2295,119,547
1400000US26081000400,"Census Tract 4, Kent County, Michigan",1417,1310,6,1198,106,107
1400000US26081000800,"Census Tract 8, Kent County, Michigan",1103,951,0,859,92,152
1400000US26081004400,"Census Tract 44, Kent County, Michigan",2651,2301,0,2214,87,350
1400000US26081011902,"Census Tract 119.02, Kent County, Michigan",2528,2459,0,2422,37,69
1400000US26081011500,"Census Tract 115, Kent County, Michigan",3186,2924,0,2621,303,262
1400000US26081013100,"Census Tract 131, Kent County, Michigan",2251,2008,44,1838,126,243
1400000US26081002200,"Census Tract 22, Kent County, Michigan",2164,2072,0,1851,221,92
1400000US26081010903,"Census Tract 109.03, Kent County, Michigan",2588,2479,14,2403,62,109
1400000US26081014601,"Census Tract 146.01, Kent County, Michigan",3284,2933,14,2810,109,351
1400000US26081002900,"Census Tract 29, Kent County, Michigan",592,551,0,545,6,41
1400000US26099250700,"Census Tract 2507, Macomb County, Michigan",1271,1148,23,1109,16,123
1400000US26099250900,"Census Tract 2509, Macomb County, Michigan",1039,916,0,872,44,123
1400000US26099251700,"Census Tract 2517, Macomb County, Michigan",1305,1152,5,1049,98,153
1400000US26099255500,"Census Tract 2555, Macomb County, Michigan",702,586,4,519,63,116
1400000US26099258000,"Census Tract 2580, Macomb County, Michigan",1070,906,0,855,51,164
1400000US26099215200,"Census Tract 2152, Macomb County, Michigan",2989,2819,0,2754,65,170
1400000US26099222500,"Census Tract 2225, Macomb County, Michigan",1656,1448,0,1360,88,208
1400000US26099223400,"Census Tract 2234, Macomb County, Michigan",3648,3472,14,3390,68,176
1400000US26099241000,"Census Tract 2410, Macomb County, Michigan",2080,1848,0,1693,155,232
1400000US26099232200,"Census Tract 2322, Macomb County, Michigan",2137,1857,0,1719,138,280
1400000US26099232300,"Census Tract 2323, Macomb County, Michigan",1935,1771,0,1608,163,164
1400000US26099240300,"Census Tract 2403, Macomb County, Michigan",1878,1663,8,1511,144,215
1400000US26045020101,"Census Tract 201.01, Eaton County, Michigan",1077,1007,0,989,18,70
1400000US26045020302,"Census Tract 203.02, Eaton County, Michigan",2508,2380,14,2306,60,128
1400000US26045020402,"Census Tract 204.02, Eaton County, Michigan",1156,1087,10,1007,70,69
1400000US26045020201,"Census Tract 202.01, Eaton County, Michigan",1189,1107,0,1003,104,82
1400000US26045020700,"Census Tract 207, Eaton County, Michigan",1499,1306,8,1146,152,193
1400000US26045020800,"Census Tract 208, Eaton County, Michigan",1904,1622,12,1452,158,282
1400000US26045021100,"Census Tract 211, Eaton County, Michigan",1780,1572,6,1400,166,208
1400000US26045020103,"Census Tract 201.03, Eaton County, Michigan",1727,1550,0,1470,80,177
1400000US26045020104,"Census Tract 201.04, Eaton County, Michigan",1529,1397,0,1296,101,132
1400000US26045020102,"Census Tract 201.02, Eaton County, Michigan",1753,1525,0,1369,156,228
1400000US26045020202,"Census Tract 202.02, Eaton County, Michigan",1999,1859,11,1587,261,140
1400000US26045020500,"Census Tract 205, Eaton County, Michigan",1435,1303,4,1109,190,132
1400000US26041970200,"Census Tract 9702, Delta County, Michigan",1000,807,3,689,115,193
1400000US26041970700,"Census Tract 9707, Delta County, Michigan",1619,1408,5,1306,97,211
1400000US26041971000,"Census Tract 9710, Delta County, Michigan",1281,994,0,847,147,287
1400000US26041970100,"Census Tract 9701, Delta County, Michigan",777,578,13,474,91,199
1400000US26099241500,"Census Tract 2415, Macomb County, Michigan",1596,1273,34,1124,115,323
1400000US26099241900,"Census Tract 2419, Macomb County, Michigan",2022,1668,9,1500,159,354
1400000US26099245100,"Census Tract 2451, Macomb County, Michigan",1558,1411,0,1305,106,147
1400000US26099251000,"Census Tract 2510, Macomb County, Michigan",745,650,0,621,29,95
1400000US26099251600,"Census Tract 2516, Macomb County, Michigan",1481,1204,0,1067,137,277
1400000US26099252200,"Census Tract 2522, Macomb County, Michigan",1506,1308,0,1247,61,198
1400000US26099254200,"Census Tract 2542, Macomb County, Michigan",1783,1560,0,1473,87,223
1400000US26099256500,"Census Tract 2565, Macomb County, Michigan",606,536,0,496,40,70
1400000US26099258100,"Census Tract 2581, Macomb County, Michigan",1439,1310,8,1157,145,129
1400000US26099260600,"Census Tract 2606, Macomb County, Michigan",1082,997,10,885,102,85
1400000US26099261400,"Census Tract 2614, Macomb County, Michigan",999,905,0,832,73,94
1400000US26099262400,"Census Tract 2624, Macomb County, Michigan",1402,1141,0,1094,47,261
1400000US26059050200,"Census Tract 502, Hillsdale County, Michigan",1186,989,13,803,173,197
1400000US26099262500,"Census Tract 2625, Macomb County, Michigan",2294,1915,38,1638,239,379
1400000US26099262800,"Census Tract 2628, Macomb County, Michigan",1040,807,0,710,97,233
1400000US26059050900,"Census Tract 509, Hillsdale County, Michigan",1986,1601,22,1454,125,385
1400000US26121002100,"Census Tract 21, Muskegon County, Michigan",1632,1386,0,1264,122,246
1400000US26121002200,"Census Tract 22, Muskegon County, Michigan",1649,1472,21,1254,197,177
1400000US26121002500,"Census Tract 25, Muskegon County, Michigan",2829,2608,16,2425,167,221
1400000US26121003100,"Census Tract 31, Muskegon County, Michigan",1620,1390,0,1263,127,230
1400000US26121003700,"Census Tract 37, Muskegon County, Michigan",2215,1992,32,1740,220,223
1400000US26121001300,"Census Tract 13, Muskegon County, Michigan",874,617,15,456,146,257
1400000US26121003200,"Census Tract 32, Muskegon County, Michigan",1936,1655,19,1329,307,281
1400000US26121003400,"Census Tract 34, Muskegon County, Michigan",1553,1337,37,1205,95,216
1400000US26121003500,"Census Tract 35, Muskegon County, Michigan",1577,1472,36,1343,93,105
1400000US26121003600,"Census Tract 36, Muskegon County, Michigan",2328,2193,9,1965,219,135
1400000US26121000500,"Census Tract 5, Muskegon County, Michigan",1737,1259,0,1011,248,478
1400000US26121000601,"Census Tract 6.01, Muskegon County, Michigan",541,440,0,395,45,101
1400000US26121001500,"Census Tract 15, Muskegon County, Michigan",1553,1415,0,1329,86,138
1400000US26121003800,"Census Tract 38, Muskegon County, Michigan",1413,1252,4,1094,154,161
1400000US26121004000,"Census Tract 40, Muskegon County, Michigan",724,705,0,603,102,19
1400000US26121001000,"Census Tract 10, Muskegon County, Michigan",609,592,0,569,23,17
1400000US26125122900,"Census Tract 1229, Oakland County, Michigan",691,639,0,585,54,52
1400000US26125127200,"Census Tract 1272, Oakland County, Michigan",682,643,0,623,20,39
1400000US26125127400,"Census Tract 1274, Oakland County, Michigan",663,642,0,606,36,21
1400000US26125130000,"Census Tract 1300, Oakland County, Michigan",1339,1162,0,1115,47,177
1400000US26125130100,"Census Tract 1301, Oakland County, Michigan",803,743,0,673,70,60
1400000US26125130200,"Census Tract 1302, Oakland County, Michigan",1999,1915,0,1826,89,84
1400000US26125130600,"Census Tract 1306, Oakland County, Michigan",1241,1191,0,1145,46,50
1400000US26125131100,"Census Tract 1311, Oakland County, Michigan",854,829,0,743,86,25
1400000US26125131400,"Census Tract 1314, Oakland County, Michigan",836,797,0,733,64,39
1400000US26125131800,"Census Tract 1318, Oakland County, Michigan",1418,1251,0,1067,184,167
1400000US26125134300,"Census Tract 1343, Oakland County, Michigan",1882,1767,12,1632,123,115
1400000US26125136000,"Census Tract 1360, Oakland County, Michigan",1174,1036,0,1028,8,138
1400000US26125139400,"Census Tract 1394, Oakland County, Michigan",1980,1854,17,1764,73,126
1400000US26125141700,"Census Tract 1417, Oakland County, Michigan",855,633,0,524,109,222
1400000US26125144100,"Census Tract 1441, Oakland County, Michigan",1732,1625,18,1527,80,107
1400000US26125144300,"Census Tract 1443, Oakland County, Michigan",1442,1344,14,1227,103,98
1400000US26125144800,"Census Tract 1448, Oakland County, Michigan",1033,947,0,823,124,86
1400000US26125145100,"Census Tract 1451, Oakland County, Michigan",901,863,0,802,61,38
1400000US26125145200,"Census Tract 1452, Oakland County, Michigan",1585,1474,10,1363,101,111
1400000US26125145400,"Census Tract 1454, Oakland County, Michigan",1689,1499,0,1400,99,190
1400000US26125153000,"Census Tract 1530, Oakland County, Michigan",1090,1047,0,998,49,43
1400000US26125157000,"Census Tract 1570, Oakland County, Michigan",806,801,0,798,3,5
1400000US26125181500,"Census Tract 1815, Oakland County, Michigan",1051,989,0,925,64,62
1400000US26125144200,"Census Tract 1442, Oakland County, Michigan",1701,1590,0,1527,63,111
1400000US26125144500,"Census Tract 1445, Oakland County, Michigan",1329,1234,0,1199,35,95
1400000US26125150000,"Census Tract 1500, Oakland County, Michigan",2338,2263,0,2144,119,75
1400000US26125158100,"Census Tract 1581, Oakland County, Michigan",1269,1171,0,1111,60,98
1400000US26125153100,"Census Tract 1531, Oakland County, Michigan",931,882,0,877,5,49
1400000US26125157500,"Census Tract 1575, Oakland County, Michigan",1475,1216,10,1139,67,259
1400000US26125158000,"Census Tract 1580, Oakland County, Michigan",1398,1345,0,1325,20,53
1400000US26125158200,"Census Tract 1582, Oakland County, Michigan",1488,1454,22,1409,23,34
1400000US26125160300,"Census Tract 1603, Oakland County, Michigan",1899,1401,9,1213,179,498
1400000US26125161600,"Census Tract 1616, Oakland County, Michigan",1093,1038,0,986,52,55
1400000US26125166000,"Census Tract 1660, Oakland County, Michigan",1182,1073,16,977,80,109
1400000US26125166600,"Census Tract 1666, Oakland County, Michigan",1919,1620,0,1466,154,299
1400000US26125167800,"Census Tract 1678, Oakland County, Michigan",1963,1880,0,1839,41,83
1400000US26163546300,"Census Tract 5463, Wayne County, Michigan",748,626,0,536,90,122
1400000US26163551500,"Census Tract 5515, Wayne County, Michigan",805,702,0,628,74,103
1400000US26163554100,"Census Tract 5541, Wayne County, Michigan",1518,1406,0,1228,178,112
1400000US26163556100,"Census Tract 5561, Wayne County, Michigan",1328,1282,11,1157,114,46
1400000US26163556900,"Census Tract 5569, Wayne County, Michigan",1398,1285,7,1207,71,113
1400000US26163558800,"Census Tract 5588, Wayne County, Michigan",1066,953,9,899,45,113
1400000US26163562300,"Census Tract 5623, Wayne County, Michigan",870,849,5,803,41,21
1400000US26163567100,"Census Tract 5671, Wayne County, Michigan",1542,1361,22,1104,235,181
1400000US26163563200,"Census Tract 5632, Wayne County, Michigan",1290,1207,0,1157,50,83
1400000US26163563900,"Census Tract 5639, Wayne County, Michigan",923,908,0,885,23,15
1400000US26163566600,"Census Tract 5666, Wayne County, Michigan",790,704,0,651,53,86
1400000US26163568200,"Census Tract 5682, Wayne County, Michigan",1464,1377,8,1280,89,87
1400000US26163569700,"Census Tract 5697, Wayne County, Michigan",1697,1515,0,1383,132,182
1400000US26125126400,"Census Tract 1264, Oakland County, Michigan",1384,1365,9,1281,75,19
1400000US26125126500,"Census Tract 1265, Oakland County, Michigan",1081,1081,0,973,108,0
1400000US26125127100,"Census Tract 1271, Oakland County, Michigan",1890,1787,8,1754,25,103
1400000US26125127700,"Census Tract 1277, Oakland County, Michigan",2468,2304,0,2168,136,164
1400000US26125128400,"Census Tract 1284, Oakland County, Michigan",1560,1484,10,1376,98,76
1400000US26125128900,"Census Tract 1289, Oakland County, Michigan",2272,2246,0,2214,32,26
1400000US26125129000,"Census Tract 1290, Oakland County, Michigan",1345,1236,17,1165,54,109
1400000US26125130300,"Census Tract 1303, Oakland County, Michigan",1370,1266,0,1152,114,104
1400000US26125131600,"Census Tract 1316, Oakland County, Michigan",1007,961,0,900,61,46
1400000US26125196700,"Census Tract 1967, Oakland County, Michigan",1000,963,0,954,9,37
1400000US26125197100,"Census Tract 1971, Oakland County, Michigan",937,880,10,850,20,57
1400000US26125128200,"Census Tract 1282, Oakland County, Michigan",1203,1167,0,1126,41,36
1400000US26125125000,"Census Tract 1250, Oakland County, Michigan",1353,1274,33,1104,137,79
1400000US26125127600,"Census Tract 1276, Oakland County, Michigan",1551,1551,10,1479,62,0
1400000US26125128300,"Census Tract 1283, Oakland County, Michigan",1885,1732,0,1662,70,153
1400000US26125130500,"Census Tract 1305, Oakland County, Michigan",1205,1098,0,1034,64,107
1400000US26125130700,"Census Tract 1307, Oakland County, Michigan",2472,2212,0,2155,57,260
1400000US26125134800,"Census Tract 1348, Oakland County, Michigan",1470,1372,0,1323,49,98
1400000US26125136600,"Census Tract 1366, Oakland County, Michigan",3026,2882,0,2762,120,144
1400000US26125136800,"Census Tract 1368, Oakland County, Michigan",2124,1726,14,1570,142,398
1400000US26125140600,"Census Tract 1406, Oakland County, Michigan",979,914,0,780,134,65
1400000US26163597000,"Census Tract 5970, Wayne County, Michigan",1769,1612,7,1511,94,157
1400000US26163584500,"Census Tract 5845, Wayne County, Michigan",1119,1020,33,839,148,99
1400000US26163595200,"Census Tract 5952, Wayne County, Michigan",1331,1061,0,938,123,270
1400000US26163585700,"Census Tract 5857, Wayne County, Michigan",647,604,9,527,68,43
1400000US26163591600,"Census Tract 5916, Wayne County, Michigan",742,696,0,671,25,46
1400000US26163594100,"Census Tract 5941, Wayne County, Michigan",1800,1582,0,1469,113,218
1400000US26163503300,"Census Tract 5033, Wayne County, Michigan",1286,1048,0,843,205,238
1400000US26163500600,"Census Tract 5006, Wayne County, Michigan",954,883,0,689,194,71
1400000US26163504900,"Census Tract 5049, Wayne County, Michigan",1315,979,0,660,319,336
1400000US26163507900,"Census Tract 5079, Wayne County, Michigan",459,354,0,266,88,105
1400000US26163513300,"Census Tract 5133, Wayne County, Michigan",1080,971,0,823,148,109
1400000US26163516600,"Census Tract 5166, Wayne County, Michigan",1106,860,0,643,217,246
1400000US26163518800,"Census Tract 5188, Wayne County, Michigan",253,168,0,118,50,85
1400000US26163520400,"Census Tract 5204, Wayne County, Michigan",1025,910,0,709,201,115
1400000US26163521500,"Census Tract 5215, Wayne County, Michigan",742,528,0,392,136,214
1400000US26163522100,"Census Tract 5221, Wayne County, Michigan",283,182,0,95,87,101
1400000US26163525500,"Census Tract 5255, Wayne County, Michigan",292,188,0,134,54,104
1400000US26163530400,"Census Tract 5304, Wayne County, Michigan",519,375,9,218,148,144
1400000US26163531500,"Census Tract 5315, Wayne County, Michigan",946,635,0,383,252,311
1400000US26163532400,"Census Tract 5324, Wayne County, Michigan",575,432,0,287,145,143
1400000US26163534100,"Census Tract 5341, Wayne County, Michigan",829,605,0,350,255,224
1400000US26163534400,"Census Tract 5344, Wayne County, Michigan",690,519,0,296,223,171
1400000US26163537100,"Census Tract 5371, Wayne County, Michigan",684,525,0,255,270,159
1400000US26163566900,"Census Tract 5669, Wayne County, Michigan",1837,1748,0,1490,258,89
1400000US26163507000,"Census Tract 5070, Wayne County, Michigan",977,602,0,425,177,375
1400000US26163501600,"Census Tract 5016, Wayne County, Michigan",824,638,0,478,160,186
1400000US26163506300,"Census Tract 5063, Wayne County, Michigan",639,404,11,271,122,235
1400000US26163506700,"Census Tract 5067, Wayne County, Michigan",365,283,0,257,26,82
1400000US26163507200,"Census Tract 5072, Wayne County, Michigan",460,248,0,182,66,212
1400000US26163510500,"Census Tract 5105, Wayne County, Michigan",1053,751,0,576,175,302
1400000US26163511200,"Census Tract 5112, Wayne County, Michigan",523,394,0,274,120,129
1400000US26163512600,"Census Tract 5126, Wayne County, Michigan",535,426,0,259,167,109
1400000US26163514300,"Census Tract 5143, Wayne County, Michigan",1072,786,0,534,252,286
1400000US26163569300,"Census Tract 5693, Wayne County, Michigan",1559,1378,12,1221,145,181
1400000US26163569900,"Census Tract 5699, Wayne County, Michigan",942,871,0,822,49,71
1400000US26163570100,"Census Tract 5701, Wayne County, Michigan",1579,1473,0,1176,297,106
1400000US26163570800,"Census Tract 5708, Wayne County, Michigan",1022,862,0,604,258,160
1400000US26163571700,"Census Tract 5717, Wayne County, Michigan",816,737,4,621,112,79
1400000US26163571800,"Census Tract 5718, Wayne County, Michigan",1065,924,0,812,112,141
1400000US26163553800,"Census Tract 5538, Wayne County, Michigan",583,460,0,295,165,123
1400000US26163554700,"Census Tract 5547, Wayne County, Michigan",1153,1039,0,978,61,114
1400000US26163554800,"Census Tract 5548, Wayne County, Michigan",1351,1158,0,1054,104,193
1400000US26163555400,"Census Tract 5554, Wayne County, Michigan",952,835,0,708,127,117
1400000US26163556300,"Census Tract 5563, Wayne County, Michigan",1388,1246,17,1175,54,142
1400000US26163557200,"Census Tract 5572, Wayne County, Michigan",790,713,0,616,97,77
1400000US26163557500,"Census Tract 5575, Wayne County, Michigan",1443,1333,10,1268,55,110
1400000US26163582100,"Census Tract 5821, Wayne County, Michigan",1477,1243,19,1164,60,234
1400000US26163580700,"Census Tract 5807, Wayne County, Michigan",1910,1555,0,1318,237,355
1400000US26163588200,"Census Tract 5882, Wayne County, Michigan",1654,1577,0,1282,295,77
1400000US26163581500,"Census Tract 5815, Wayne County, Michigan",980,851,0,757,94,129
1400000US26163581800,"Census Tract 5818, Wayne County, Michigan",1037,941,12,858,71,96
1400000US26163584300,"Census Tract 5843, Wayne County, Michigan",759,681,0,566,115,78
1400000US26163588300,"Census Tract 5883, Wayne County, Michigan",1928,1629,0,1432,197,299
1400000US26163588400,"Census Tract 5884, Wayne County, Michigan",1873,1757,0,1698,59,116
1400000US26163594500,"Census Tract 5945, Wayne County, Michigan",1316,1166,26,1019,121,150
1400000US26163596100,"Census Tract 5961, Wayne County, Michigan",1521,1458,10,1346,102,63
1400000US26163596300,"Census Tract 5963, Wayne County, Michigan",1011,926,0,881,45,85
1400000US26129950200,"Census Tract 9502, Ogemaw County, Michigan",1359,1149,28,936,185,210
1400000US26135970500,"Census Tract 9705, Oscoda County, Michigan",750,590,11,461,118,160
1400000US26135970300,"Census Tract 9703, Oscoda County, Michigan",777,517,7,449,61,260
1400000US26135970400,"Census Tract 9704, Oscoda County, Michigan",849,612,13,474,125,237
1400000US26039960100,"Census Tract 9601, Crawford County, Michigan",990,885,11,764,110,105
1400000US26039960200,"Census Tract 9602, Crawford County, Michigan",1374,1221,8,1139,74,153
1400000US26039960400,"Census Tract 9604, Crawford County, Michigan",1089,962,17,835,110,127
1400000US26039960500,"Census Tract 9605, Crawford County, Michigan",1042,868,5,782,81,174
1400000US26039960300,"Census Tract 9603, Crawford County, Michigan",1552,1323,3,1179,141,229
1400000US26037010203,"Census Tract 102.03, Clinton County, Michigan",568,505,0,425,80,63
1400000US26037010600,"Census Tract 106, Clinton County, Michigan",960,834,18,744,72,126
1400000US26037010204,"Census Tract 102.04, Clinton County, Michigan",648,595,0,585,10,53
1400000US26037010300,"Census Tract 103, Clinton County, Michigan",1818,1703,8,1593,102,115
1400000US26037010400,"Census Tract 104, Clinton County, Michigan",1815,1564,6,1424,134,251
1400000US26147651600,"Census Tract 6516, St. Clair County, Michigan",1564,1443,0,1339,104,121
1400000US26147652600,"Census Tract 6526, St. Clair County, Michigan",1251,1141,17,1036,88,110
1400000US26147658100,"Census Tract 6581, St. Clair County, Michigan",954,828,5,783,40,126
1400000US26147623000,"Census Tract 6230, St. Clair County, Michigan",1089,861,24,731,106,228
1400000US26147625000,"Census Tract 6250, St. Clair County, Michigan",681,571,0,510,61,110
1400000US26147628000,"Census Tract 6280, St. Clair County, Michigan",1408,1279,0,1115,164,129
1400000US26147634600,"Census Tract 6346, St. Clair County, Michigan",2143,1976,11,1836,129,167
1400000US26147637100,"Census Tract 6371, St. Clair County, Michigan",1498,1381,0,1327,54,117
1400000US26007000400,"Census Tract 4, Alpena County, Michigan",1323,1045,11,939,95,278
1400000US26007000100,"Census Tract 1, Alpena County, Michigan",1854,1507,18,1319,170,347
1400000US26007000700,"Census Tract 7, Alpena County, Michigan",1379,1083,12,936,135,296
1400000US26007000300,"Census Tract 3, Alpena County, Michigan",1503,1286,0,1130,156,217
1400000US26007000200,"Census Tract 2, Alpena County, Michigan",1697,1426,0,1215,211,271
1400000US26007000900,"Census Tract 9, Alpena County, Michigan",1269,1086,10,964,112,183
1400000US26007000500,"Census Tract 5, Alpena County, Michigan",899,764,10,689,65,135
1400000US26007000800,"Census Tract 8, Alpena County, Michigan",1383,1214,12,1075,127,169
1400000US26007000600,"Census Tract 6, Alpena County, Michigan",1410,1133,13,1054,66,277
1400000US26067030300,"Census Tract 303, Ionia County, Michigan",1173,986,0,907,79,187
1400000US26067030400,"Census Tract 304, Ionia County, Michigan",2494,2218,15,1832,371,276
1400000US26067031400,"Census Tract 314, Ionia County, Michigan",1673,1479,6,1356,117,194
1400000US26067031600,"Census Tract 316, Ionia County, Michigan",2183,1859,22,1497,340,324
1400000US26067030100,"Census Tract 301, Ionia County, Michigan",2480,2094,23,1715,356,386
1400000US26067031700,"Census Tract 317, Ionia County, Michigan",1626,1520,0,1421,99,106
1400000US26065004000,"Census Tract 40, Ingham County, Michigan",1753,1611,0,1473,138,142
1400000US26065002901,"Census Tract 29.01, Ingham County, Michigan",1358,1254,10,1078,166,104
1400000US26065003302,"Census Tract 33.02, Ingham County, Michigan",994,873,0,803,70,121
1400000US26065005100,"Census Tract 51, Ingham County, Michigan",1269,1188,0,1036,152,81
1400000US26065005304,"Census Tract 53.04, Ingham County, Michigan",1277,1002,0,924,78,275
1400000US26091060600,"Census Tract 606, Lenawee County, Michigan",2202,2133,20,2030,83,69
1400000US26091060500,"Census Tract 605, Lenawee County, Michigan",1334,1134,20,910,204,200
1400000US26091061302,"Census Tract 613.02, Lenawee County, Michigan",1198,1033,0,832,201,165
1400000US26091061600,"Census Tract 616, Lenawee County, Michigan",1634,1331,0,1169,162,303
1400000US26091061800,"Census Tract 618, Lenawee County, Michigan",1534,1375,10,1203,162,159
1400000US26091060800,"Census Tract 608, Lenawee County, Michigan",1529,1362,0,1189,173,167
1400000US26091061200,"Census Tract 612, Lenawee County, Michigan",723,638,6,582,50,85
1400000US26091060100,"Census Tract 601, Lenawee County, Michigan",1399,1300,21,1148,131,99
1400000US26091061301,"Census Tract 613.01, Lenawee County, Michigan",1302,1065,0,915,150,237
1400000US26091061900,"Census Tract 619, Lenawee County, Michigan",1839,1625,25,1399,201,214
1400000US26091060700,"Census Tract 607, Lenawee County, Michigan",2589,2392,14,2115,263,197
1400000US26091061700,"Census Tract 617, Lenawee County, Michigan",2910,2624,13,2311,300,286
1400000US26091061500,"Census Tract 615, Lenawee County, Michigan",1923,1819,21,1622,176,104
1400000US26091062000,"Census Tract 620, Lenawee County, Michigan",1078,932,2,807,123,146
1400000US26091061400,"Census Tract 614, Lenawee County, Michigan",1414,1065,0,937,128,349
1400000US26105950400,"Census Tract 9504, Mason County, Michigan",2100,1627,12,1345,270,473
1400000US26105950600,"Census Tract 9506, Mason County, Michigan",1979,1741,30,1500,211,238
1400000US26105950100,"Census Tract 9501, Mason County, Michigan",975,816,21,646,149,159
1400000US26105950200,"Census Tract 9502, Mason County, Michigan",1506,1323,16,1129,178,183
1400000US26105950700,"Census Tract 9507, Mason County, Michigan",1271,1049,11,770,268,222
1400000US26105950300,"Census Tract 9503, Mason County, Michigan",1648,1503,0,1392,111,145
1400000US26105950500,"Census Tract 9505, Mason County, Michigan",1518,1337,0,1149,188,181
1400000US26105950800,"Census Tract 9508, Mason County, Michigan",1118,996,12,866,118,122
1400000US26109960200,"Census Tract 9602, Menominee County, Michigan",1621,1279,15,1151,113,342
1400000US26075001100,"Census Tract 11, Jackson County, Michigan",760,557,3,504,50,203
1400000US26075006301,"Census Tract 63.01, Jackson County, Michigan",1269,1152,27,1041,84,117
1400000US26075000900,"Census Tract 9, Jackson County, Michigan",1400,1275,0,1156,119,125
1400000US26075005400,"Census Tract 54, Jackson County, Michigan",2063,1854,11,1818,25,209
1400000US26075005700,"Census Tract 57, Jackson County, Michigan",1228,1086,0,982,104,142
1400000US26075006702,"Census Tract 67.02, Jackson County, Michigan",1877,1725,0,1592,133,152
1400000US26075001300,"Census Tract 13, Jackson County, Michigan",954,745,0,595,150,209
1400000US26075005301,"Census Tract 53.01, Jackson County, Michigan",2137,1877,11,1723,143,260
1400000US26075005302,"Census Tract 53.02, Jackson County, Michigan",1651,1511,0,1336,175,140
1400000US26075005000,"Census Tract 50, Jackson County, Michigan",896,806,5,735,66,90
1400000US26075005600,"Census Tract 56, Jackson County, Michigan",3050,2783,0,2375,408,267
1400000US26075005800,"Census Tract 58, Jackson County, Michigan",0,0,0,0,0,0
1400000US26161407600,"Census Tract 4076, Washtenaw County, Michigan",1019,988,0,883,105,31
1400000US26161410600,"Census Tract 4106, Washtenaw County, Michigan",815,689,0,578,111,126
1400000US26161411000,"Census Tract 4110, Washtenaw County, Michigan",1359,1260,6,1105,149,99
1400000US26161414700,"Census Tract 4147, Washtenaw County, Michigan",935,875,7,786,82,60
1400000US26161415400,"Census Tract 4154, Washtenaw County, Michigan",882,882,0,832,50,0
1400000US26093742900,"Census Tract 7429, Livingston County, Michigan",1428,1401,16,1334,51,27
1400000US26161415600,"Census Tract 4156, Washtenaw County, Michigan",688,674,0,663,11,14
1400000US26161420000,"Census Tract 4200, Washtenaw County, Michigan",1257,1178,0,1133,45,79
1400000US26161423600,"Census Tract 4236, Washtenaw County, Michigan",1014,980,10,891,79,34
1400000US26093743700,"Census Tract 7437, Livingston County, Michigan",1121,1046,0,985,61,75
1400000US26093744600,"Census Tract 7446, Livingston County, Michigan",620,597,0,557,40,23
1400000US26093711000,"Census Tract 7110, Livingston County, Michigan",1441,1312,8,1205,99,129
1400000US26093713500,"Census Tract 7135, Livingston County, Michigan",1426,1298,10,1208,80,128
1400000US26093740500,"Census Tract 7405, Livingston County, Michigan",854,811,0,777,34,43
1400000US26093740600,"Census Tract 7406, Livingston County, Michigan",1055,1025,0,1025,0,30
1400000US26093740900,"Census Tract 7409, Livingston County, Michigan",709,681,16,626,39,28
1400000US26093744200,"Census Tract 7442, Livingston County, Michigan",1505,1463,11,1332,120,42
1400000US26093744800,"Census Tract 7448, Livingston County, Michigan",1519,1434,9,1366,59,85
1400000US26093710500,"Census Tract 7105, Livingston County, Michigan",646,608,4,546,58,38
1400000US26093720100,"Census Tract 7201, Livingston County, Michigan",1133,1103,16,1019,68,30
1400000US26093744700,"Census Tract 7447, Livingston County, Michigan",1327,1235,0,1129,106,92
1400000US26093743900,"Census Tract 7439, Livingston County, Michigan",1415,1356,0,1336,20,59
1400000US26093710100,"Census Tract 7101, Livingston County, Michigan",858,836,4,801,31,22
1400000US26163541500,"Census Tract 5415, Wayne County, Michigan",1667,1423,15,1107,301,244
1400000US26163541700,"Census Tract 5417, Wayne County, Michigan",1317,1042,0,693,349,275
1400000US26163543200,"Census Tract 5432, Wayne County, Michigan",1092,1005,0,752,253,87
1400000US26163545300,"Census Tract 5453, Wayne County, Michigan",562,535,0,448,87,27
1400000US26163545400,"Census Tract 5454, Wayne County, Michigan",684,521,0,297,224,163
1400000US26163545600,"Census Tract 5456, Wayne County, Michigan",1556,1270,0,1064,206,286
1400000US26163546700,"Census Tract 5467, Wayne County, Michigan",1072,991,9,646,336,81
1400000US26163550200,"Census Tract 5502, Wayne County, Michigan",1632,1468,7,1329,132,164
1400000US26163551400,"Census Tract 5514, Wayne County, Michigan",1541,1336,0,1254,82,205
1400000US26163551800,"Census Tract 5518, Wayne County, Michigan",1387,1234,13,1204,17,153
1400000US26163552000,"Census Tract 5520, Wayne County, Michigan",914,762,8,597,157,152
1400000US26163552300,"Census Tract 5523, Wayne County, Michigan",989,768,0,614,154,221
1400000US26163555100,"Census Tract 5551, Wayne County, Michigan",1710,1573,0,1408,165,137
1400000US26163557400,"Census Tract 5574, Wayne County, Michigan",1218,1113,0,1067,46,105
1400000US26163557600,"Census Tract 5576, Wayne County, Michigan",1105,1046,0,989,57,59
1400000US26163557900,"Census Tract 5579, Wayne County, Michigan",1802,1646,10,1572,64,156
1400000US26163572500,"Census Tract 5725, Wayne County, Michigan",556,519,0,414,105,37
1400000US26163573000,"Census Tract 5730, Wayne County, Michigan",839,802,0,746,56,37
1400000US26163574600,"Census Tract 5746, Wayne County, Michigan",1766,1663,0,1491,172,103
1400000US26163575600,"Census Tract 5756, Wayne County, Michigan",564,514,10,406,98,50
1400000US26163577400,"Census Tract 5774, Wayne County, Michigan",1331,1266,0,1028,238,65
1400000US26163577600,"Census Tract 5776, Wayne County, Michigan",1378,1203,25,982,196,175
1400000US26163577800,"Census Tract 5778, Wayne County, Michigan",1810,1669,0,1578,91,141
1400000US26163578000,"Census Tract 5780, Wayne County, Michigan",1039,866,0,589,277,173
1400000US26163579500,"Census Tract 5795, Wayne County, Michigan",580,397,0,276,121,183
1400000US26163558100,"Census Tract 5581, Wayne County, Michigan",1307,1102,14,1045,43,205
1400000US26035000800,"Census Tract 8, Clare County, Michigan",1544,1108,20,954,134,436
1400000US26037010104,"Census Tract 101.04, Clinton County, Michigan",1423,1330,35,1225,70,93
1400000US26035000900,"Census Tract 9, Clare County, Michigan",754,627,0,509,118,127
1400000US26035001000,"Census Tract 10, Clare County, Michigan",1118,848,0,736,112,270
1400000US26035001300,"Census Tract 13, Clare County, Michigan",1675,1391,2,1145,244,284
1400000US26037010105,"Census Tract 101.05, Clinton County, Michigan",1321,1231,8,1207,16,90
1400000US26037010107,"Census Tract 101.07, Clinton County, Michigan",1505,1434,0,1360,74,71
1400000US26037010108,"Census Tract 101.08, Clinton County, Michigan",1529,1465,0,1434,31,64
1400000US26037010801,"Census Tract 108.01, Clinton County, Michigan",1615,1428,0,1293,135,187
1400000US26037010802,"Census Tract 108.02, Clinton County, Michigan",1546,1363,0,1286,77,183
1400000US26037011104,"Census Tract 111.04, Clinton County, Michigan",2650,2507,0,2430,77,143
1400000US26037011200,"Census Tract 112, Clinton County, Michigan",803,797,7,577,213,6
1400000US26041990000,"Census Tract 9900, Delta County, Michigan",0,0,0,0,0,0
1400000US26041990100,"Census Tract 9901, Delta County, Michigan",0,0,0,0,0,0
1400000US26045020303,"Census Tract 203.03, Eaton County, Michigan",1697,1618,0,1448,170,79
1400000US26045020304,"Census Tract 203.04, Eaton County, Michigan",2467,2372,12,2093,267,95
1400000US26045020403,"Census Tract 204.03, Eaton County, Michigan",1206,1047,0,847,200,159
1400000US26045020404,"Census Tract 204.04, Eaton County, Michigan",2028,1753,10,1515,228,275
1400000US26045020601,"Census Tract 206.01, Eaton County, Michigan",1498,1438,0,1292,146,60
1400000US26045020602,"Census Tract 206.02, Eaton County, Michigan",1322,1177,14,1035,128,145
1400000US26045020901,"Census Tract 209.01, Eaton County, Michigan",1365,1134,25,918,191,231
1400000US26117971100,"Census Tract 9711, Montcalm County, Michigan",2005,1672,45,1358,269,333
1400000US26117971200,"Census Tract 9712, Montcalm County, Michigan",2318,1881,0,1696,185,437
1400000US26117971300,"Census Tract 9713, Montcalm County, Michigan",2130,1642,0,1428,214,488
1400000US26119910100,"Census Tract 9101, Montmorency County, Michigan",1077,847,14,671,162,230
1400000US26119910200,"Census Tract 9102, Montmorency County, Michigan",691,571,4,518,49,120
1400000US26119910300,"Census Tract 9103, Montmorency County, Michigan",768,614,15,508,91,154
1400000US26119910400,"Census Tract 9104, Montmorency County, Michigan",1031,839,28,728,83,192
1400000US26119910500,"Census Tract 9105, Montmorency County, Michigan",628,541,0,467,74,87
1400000US26121000401,"Census Tract 4.01, Muskegon County, Michigan",1739,1522,10,1325,187,217
1400000US26121000402,"Census Tract 4.02, Muskegon County, Michigan",282,213,0,184,29,69
1400000US26121004200,"Census Tract 42, Muskegon County, Michigan",1614,1270,0,1009,261,344
1400000US26121004300,"Census Tract 43, Muskegon County, Michigan",776,567,0,403,164,209
1400000US26121990000,"Census Tract 9900, Muskegon County, Michigan",0,0,0,0,0,0
1400000US26125121700,"Census Tract 1217, Oakland County, Michigan",1995,1882,0,1802,80,113
1400000US26125121800,"Census Tract 1218, Oakland County, Michigan",1747,1657,0,1479,178,90
1400000US26125133001,"Census Tract 1330.01, Oakland County, Michigan",943,932,0,932,0,11
1400000US26125133002,"Census Tract 1330.02, Oakland County, Michigan",1198,1145,10,1083,52,53
1400000US26125133003,"Census Tract 1330.03, Oakland County, Michigan",1440,1388,0,1342,46,52
1400000US26125135000,"Census Tract 1350, Oakland County, Michigan",1146,1090,8,974,108,56
1400000US26125135100,"Census Tract 1351, Oakland County, Michigan",1969,1905,8,1829,68,64
1400000US26125135200,"Census Tract 1352, Oakland County, Michigan",1346,1296,0,1250,46,50
1400000US26125135300,"Census Tract 1353, Oakland County, Michigan",1674,1627,0,1608,19,47
1400000US26125136101,"Census Tract 1361.01, Oakland County, Michigan",1977,1954,0,1882,72,23
1400000US26125136102,"Census Tract 1361.02, Oakland County, Michigan",2384,2264,0,2025,239,120
1400000US26125138301,"Census Tract 1383.01, Oakland County, Michigan",1468,1336,0,1280,56,132
1400000US26125140900,"Census Tract 1409, Oakland County, Michigan",1177,947,0,821,126,230
1400000US26125138302,"Census Tract 1383.02, Oakland County, Michigan",2459,2239,0,2176,63,220
1400000US26125140301,"Census Tract 1403.01, Oakland County, Michigan",1959,1782,0,1597,185,177
1400000US26125140302,"Census Tract 1403.02, Oakland County, Michigan",1721,1662,0,1624,38,59
1400000US26125143500,"Census Tract 1435, Oakland County, Michigan",2303,2237,0,2080,157,66
1400000US26125144701,"Census Tract 1447.01, Oakland County, Michigan",1765,1540,11,1280,249,225
1400000US26125145501,"Census Tract 1455.01, Oakland County, Michigan",1509,1414,0,1344,70,95
1400000US26125145502,"Census Tract 1455.02, Oakland County, Michigan",1542,1437,0,1275,162,105
1400000US26125145900,"Census Tract 1459, Oakland County, Michigan",1432,1169,0,1026,143,263
1400000US26125168700,"Census Tract 1687, Oakland County, Michigan",1673,1567,8,1474,85,106
1400000US26125168800,"Census Tract 1688, Oakland County, Michigan",808,799,4,762,33,9
1400000US26125168900,"Census Tract 1689, Oakland County, Michigan",2916,2670,0,2531,139,246
1400000US26045020902,"Census Tract 209.02, Eaton County, Michigan",1700,1549,6,1388,155,151
1400000US26045021001,"Census Tract 210.01, Eaton County, Michigan",1634,1502,10,1430,62,132
1400000US26045021002,"Census Tract 210.02, Eaton County, Michigan",1562,1431,19,1261,151,131
1400000US26045021201,"Census Tract 212.01, Eaton County, Michigan",1167,1041,8,983,50,126
1400000US26045021202,"Census Tract 212.02, Eaton County, Michigan",1402,1266,17,1146,103,136
1400000US26045021301,"Census Tract 213.01, Eaton County, Michigan",1158,1027,0,853,174,131
1400000US26045021302,"Census Tract 213.02, Eaton County, Michigan",1353,1134,0,1019,115,219
1400000US26045021401,"Census Tract 214.01, Eaton County, Michigan",1549,1305,10,1166,129,244
1400000US26045021402,"Census Tract 214.02, Eaton County, Michigan",1726,1554,24,1419,111,172
1400000US26047990000,"Census Tract 9900, Emmet County, Michigan",0,0,0,0,0,0
1400000US26049013500,"Census Tract 135, Genesee County, Michigan",2136,1451,0,1230,221,685
1400000US26049013600,"Census Tract 136, Genesee County, Michigan",767,469,0,362,107,298
1400000US26049980000,"Census Tract 9800, Genesee County, Michigan",9,5,0,5,0,4
1400000US26049980100,"Census Tract 9801, Genesee County, Michigan",0,0,0,0,0,0
1400000US26051000100,"Census Tract 1, Gladwin County, Michigan",1395,1081,39,883,159,314
1400000US26051000200,"Census Tract 2, Gladwin County, Michigan",715,571,3,513,55,144
1400000US26051000300,"Census Tract 3, Gladwin County, Michigan",903,634,19,537,78,269
1400000US26051000400,"Census Tract 4, Gladwin County, Michigan",1232,964,6,809,149,268
1400000US26051000500,"Census Tract 5, Gladwin County, Michigan",1502,1187,52,966,169,315
1400000US26051000600,"Census Tract 6, Gladwin County, Michigan",860,601,16,477,108,259
1400000US26051000700,"Census Tract 7, Gladwin County, Michigan",1794,1433,3,1237,193,361
1400000US26051000800,"Census Tract 8, Gladwin County, Michigan",1743,1320,4,1126,190,423
1400000US26051000900,"Census Tract 9, Gladwin County, Michigan",855,664,0,559,105,191
1400000US26053990000,"Census Tract 9900, Gogebic County, Michigan",0,0,0,0,0,0
1400000US26093710300,"Census Tract 7103, Livingston County, Michigan",1463,1325,8,1178,139,138
1400000US26093721100,"Census Tract 7211, Livingston County, Michigan",1285,1170,10,912,248,115
1400000US26093740800,"Census Tract 7408, Livingston County, Michigan",1034,988,0,923,65,46
1400000US26093742500,"Census Tract 7425, Livingston County, Michigan",769,746,0,700,46,23
1400000US26093743500,"Census Tract 7435, Livingston County, Michigan",727,714,5,640,69,13
1400000US26093743600,"Census Tract 7436, Livingston County, Michigan",1117,1080,0,1018,62,37
1400000US26093744400,"Census Tract 7444, Livingston County, Michigan",773,743,7,705,31,30
1400000US26093722100,"Census Tract 7221, Livingston County, Michigan",1117,962,20,862,80,155
1400000US26093740300,"Census Tract 7403, Livingston County, Michigan",788,735,0,688,47,53
1400000US26093725000,"Census Tract 7250, Livingston County, Michigan",2556,1979,0,1805,174,577
1400000US26093725100,"Census Tract 7251, Livingston County, Michigan",1758,1593,9,1378,206,165
1400000US26093731100,"Census Tract 7311, Livingston County, Michigan",1309,1254,15,1034,205,55
1400000US26093742700,"Census Tract 7427, Livingston County, Michigan",1510,1433,5,1326,102,77
1400000US26093713100,"Census Tract 7131, Livingston County, Michigan",1727,1637,0,1532,105,90
1400000US26093713700,"Census Tract 7137, Livingston County, Michigan",1463,1404,0,1305,99,59
1400000US26093740700,"Census Tract 7407, Livingston County, Michigan",934,929,7,922,0,5
1400000US26093741100,"Census Tract 7411, Livingston County, Michigan",1246,1089,12,989,88,157
1400000US26025003400,"Census Tract 34, Calhoun County, Michigan",581,483,0,420,63,98
1400000US26025000300,"Census Tract 3, Calhoun County, Michigan",843,607,0,490,117,236
1400000US26025000500,"Census Tract 5, Calhoun County, Michigan",1164,1029,0,820,209,135
1400000US26025000700,"Census Tract 7, Calhoun County, Michigan",879,644,0,600,44,235
1400000US26025000800,"Census Tract 8, Calhoun County, Michigan",1152,1025,9,846,170,127
1400000US26025001900,"Census Tract 19, Calhoun County, Michigan",1607,1473,9,1380,84,134
1400000US26025002200,"Census Tract 22, Calhoun County, Michigan",1266,1121,0,988,133,145
1400000US26025002300,"Census Tract 23, Calhoun County, Michigan",1553,1430,54,1303,73,123
1400000US26025002400,"Census Tract 24, Calhoun County, Michigan",1105,999,0,880,119,106
1400000US26025003500,"Census Tract 35, Calhoun County, Michigan",920,752,22,602,128,168
1400000US26025001300,"Census Tract 13, Calhoun County, Michigan",1643,1330,7,1288,35,313
1400000US26065001000,"Census Tract 10, Ingham County, Michigan",973,938,6,808,124,35
1400000US26065003902,"Census Tract 39.02, Ingham County, Michigan",1739,1516,0,1336,180,223
1400000US26065002000,"Census Tract 20, Ingham County, Michigan",1303,1239,0,852,387,64
1400000US26065002600,"Census Tract 26, Ingham County, Michigan",884,692,6,573,113,192
1400000US26065005600,"Census Tract 56, Ingham County, Michigan",1091,1029,11,881,137,62
1400000US26065005900,"Census Tract 59, Ingham County, Michigan",2019,1786,75,1607,104,233
1400000US26065006100,"Census Tract 61, Ingham County, Michigan",1580,1398,9,1178,211,182
1400000US26065004902,"Census Tract 49.02, Ingham County, Michigan",2111,2046,10,1552,484,65
1400000US26065003200,"Census Tract 32, Ingham County, Michigan",846,665,0,604,61,181
1400000US26065003801,"Census Tract 38.01, Ingham County, Michigan",1749,1667,0,1591,76,82
1400000US26065004901,"Census Tract 49.01, Ingham County, Michigan",2903,2816,13,2708,95,87
1400000US26065005001,"Census Tract 50.01, Ingham County, Michigan",2809,2672,15,2530,127,137
1400000US26065005302,"Census Tract 53.02, Ingham County, Michigan",2802,2658,18,2488,152,144
1400000US26065006500,"Census Tract 65, Ingham County, Michigan",1573,1489,0,1241,248,84
1400000US26065005800,"Census Tract 58, Ingham County, Michigan",2306,2169,7,1946,216,137
1400000US26065000600,"Census Tract 6, Ingham County, Michigan",862,796,0,699,97,66
1400000US26065001200,"Census Tract 12, Ingham County, Michigan",852,740,0,607,133,112
1400000US26065002200,"Census Tract 22, Ingham County, Michigan",737,706,0,667,39,31
1400000US26065003601,"Census Tract 36.01, Ingham County, Michigan",1299,1168,0,1011,157,131
1400000US26065003802,"Census Tract 38.02, Ingham County, Michigan",2148,2074,0,1842,232,74
1400000US26065004700,"Census Tract 47, Ingham County, Michigan",1450,1222,9,1120,93,228
1400000US26065005002,"Census Tract 50.02, Ingham County, Michigan",1316,1228,0,1200,28,88
1400000US26065005202,"Census Tract 52.02, Ingham County, Michigan",1112,1087,8,1007,72,25
1400000US26065005502,"Census Tract 55.02, Ingham County, Michigan",2490,2345,0,2178,167,145
1400000US26065005700,"Census Tract 57, Ingham County, Michigan",1921,1797,26,1643,128,124
1400000US26161420200,"Census Tract 4202, Washtenaw County, Michigan",1233,1181,0,1104,77,52
1400000US26161400600,"Census Tract 4006, Washtenaw County, Michigan",2297,2236,0,2105,131,61
1400000US26161422200,"Census Tract 4222, Washtenaw County, Michigan",2502,2383,0,2252,131,119
1400000US26161432000,"Census Tract 4320, Washtenaw County, Michigan",1842,1665,25,1458,182,177
1400000US26161400300,"Census Tract 4003, Washtenaw County, Michigan",1943,1943,0,1549,394,0
1400000US26161404200,"Census Tract 4042, Washtenaw County, Michigan",1165,1075,0,1024,51,90
1400000US26161414500,"Census Tract 4145, Washtenaw County, Michigan",948,943,0,917,26,5
1400000US26161423400,"Census Tract 4234, Washtenaw County, Michigan",2765,2473,0,2405,68,292
1400000US26161453000,"Census Tract 4530, Washtenaw County, Michigan",2011,1967,11,1923,33,44
1400000US26161445000,"Census Tract 4450, Washtenaw County, Michigan",977,865,25,715,125,112
1400000US26161404400,"Census Tract 4044, Washtenaw County, Michigan",863,827,0,805,22,36
1400000US26161410100,"Census Tract 4101, Washtenaw County, Michigan",1618,1496,15,1261,220,122
1400000US26161412600,"Census Tract 4126, Washtenaw County, Michigan",1508,1393,8,1244,141,115
1400000US26161431000,"Census Tract 4310, Washtenaw County, Michigan",1969,1751,25,1511,215,218
1400000US26161456000,"Census Tract 4560, Washtenaw County, Michigan",2223,2211,0,2134,77,12
1400000US26161410400,"Census Tract 4104, Washtenaw County, Michigan",1502,1348,14,1277,57,154
1400000US26161410900,"Census Tract 4109, Washtenaw County, Michigan",602,588,0,562,26,14
1400000US26161414000,"Census Tract 4140, Washtenaw County, Michigan",1636,1440,0,1385,55,196
1400000US26161414200,"Census Tract 4142, Washtenaw County, Michigan",1338,1155,9,1103,43,183
1400000US26161426000,"Census Tract 4260, Washtenaw County, Michigan",1548,1368,6,1260,102,180
1400000US26161400500,"Census Tract 4005, Washtenaw County, Michigan",2407,2319,0,2117,202,88
1400000US26161400200,"Census Tract 4002, Washtenaw County, Michigan",81,81,0,48,33,0
1400000US26161402600,"Census Tract 4026, Washtenaw County, Michigan",583,583,0,366,217,0
1400000US26161402700,"Census Tract 4027, Washtenaw County, Michigan",2183,2154,0,2115,39,29
1400000US26029001000,"Census Tract 10, Charlevoix County, Michigan",916,794,7,683,104,122
1400000US26029001100,"Census Tract 11, Charlevoix County, Michigan",837,680,0,594,86,157
1400000US26029001200,"Census Tract 12, Charlevoix County, Michigan",1197,1097,6,950,141,100
1400000US26029001300,"Census Tract 13, Charlevoix County, Michigan",733,667,0,561,106,66
1400000US26099268200,"Census Tract 2682, Macomb County, Michigan",1504,1432,8,1339,85,72
1400000US26099268300,"Census Tract 2683, Macomb County, Michigan",1048,723,0,634,89,325
1400000US26099268400,"Census Tract 2684, Macomb County, Michigan",1302,1045,0,965,80,257
1400000US26099982000,"Census Tract 9820, Macomb County, Michigan",5,5,0,5,0,0
1400000US26099982100,"Census Tract 9821, Macomb County, Michigan",0,0,0,0,0,0
1400000US26099982200,"Census Tract 9822, Macomb County, Michigan",0,0,0,0,0,0
1400000US26099982300,"Census Tract 9823, Macomb County, Michigan",0,0,0,0,0,0
1400000US26099990100,"Census Tract 9901, Macomb County, Michigan",0,0,0,0,0,0
1400000US26101000100,"Census Tract 1, Manistee County, Michigan",1323,1072,16,939,117,251
1400000US26101000200,"Census Tract 2, Manistee County, Michigan",742,657,4,596,57,85
1400000US26101000300,"Census Tract 3, Manistee County, Michigan",789,697,11,584,102,92
1400000US26101000400,"Census Tract 4, Manistee County, Michigan",963,825,0,728,97,138
1400000US26101000500,"Census Tract 5, Manistee County, Michigan",1038,846,19,723,104,192
1400000US26101000600,"Census Tract 6, Manistee County, Michigan",579,447,15,383,49,132
1400000US26101000700,"Census Tract 7, Manistee County, Michigan",1668,1298,5,1187,106,370
1400000US26101000800,"Census Tract 8, Manistee County, Michigan",1500,1328,0,1212,116,172
1400000US26101000900,"Census Tract 9, Manistee County, Michigan",989,854,0,704,150,135
1400000US26101990000,"Census Tract 9900, Manistee County, Michigan",0,0,0,0,0,0
1400000US26105990000,"Census Tract 9900, Mason County, Michigan",0,0,0,0,0,0
1400000US26103002800,"Census Tract 28, Marquette County, Michigan",1587,1457,0,1246,211,130
1400000US26103002900,"Census Tract 29, Marquette County, Michigan",1734,1501,15,1307,179,233
1400000US26103990000,"Census Tract 9900, Marquette County, Michigan",0,0,0,0,0,0
1400000US26107981300,"Census Tract 9813, Mecosta County, Michigan",3,3,0,3,0,0
1400000US26109990000,"Census Tract 9900, Menominee County, Michigan",0,0,0,0,0,0
1400000US26111291601,"Census Tract 2916.01, Midland County, Michigan",1016,908,27,770,111,108
1400000US26111291602,"Census Tract 2916.02, Midland County, Michigan",1976,1661,44,1509,108,315
1400000US26115990000,"Census Tract 9900, Monroe County, Michigan",0,0,0,0,0,0
1400000US26117970100,"Census Tract 9701, Montcalm County, Michigan",1719,1473,46,1174,253,246
1400000US26117970200,"Census Tract 9702, Montcalm County, Michigan",1318,1051,6,933,112,267
1400000US26117970300,"Census Tract 9703, Montcalm County, Michigan",1330,1083,0,881,202,247
1400000US26117970400,"Census Tract 9704, Montcalm County, Michigan",1303,1059,23,880,156,244
1400000US26117970500,"Census Tract 9705, Montcalm County, Michigan",2653,2239,19,1823,397,414
1400000US26117970600,"Census Tract 9706, Montcalm County, Michigan",1969,1692,10,1359,323,277
1400000US26117970700,"Census Tract 9707, Montcalm County, Michigan",2223,1704,16,1525,163,519
1400000US26117970800,"Census Tract 9708, Montcalm County, Michigan",1764,1443,14,1244,185,321
1400000US26117970900,"Census Tract 9709, Montcalm County, Michigan",1333,1122,5,915,202,211
1400000US26117971000,"Census Tract 9710, Montcalm County, Michigan",1696,1349,13,1074,262,347
1400000US26029001400,"Census Tract 14, Charlevoix County, Michigan",564,501,5,446,50,63
1400000US26029001500,"Census Tract 15, Charlevoix County, Michigan",1360,1165,15,937,213,195
1400000US26029990000,"Census Tract 9900, Charlevoix County, Michigan",0,0,0,0,0,0
1400000US26031990000,"Census Tract 9900, Cheboygan County, Michigan",0,0,0,0,0,0
1400000US26033980100,"Census Tract 9801, Chippewa County, Michigan",0,0,0,0,0,0
1400000US26033980200,"Census Tract 9802, Chippewa County, Michigan",0,0,0,0,0,0
1400000US26033980300,"Census Tract 9803, Chippewa County, Michigan",0,0,0,0,0,0
1400000US26033990000,"Census Tract 9900, Chippewa County, Michigan",0,0,0,0,0,0
1400000US26033990100,"Census Tract 9901, Chippewa County, Michigan",0,0,0,0,0,0
1400000US26035000100,"Census Tract 1, Clare County, Michigan",767,610,3,478,129,157
1400000US26035000200,"Census Tract 2, Clare County, Michigan",519,425,2,341,82,94
1400000US26035000300,"Census Tract 3, Clare County, Michigan",1027,798,5,598,195,229
1400000US26035000400,"Census Tract 4, Clare County, Michigan",1463,1220,3,1035,182,243
1400000US26035000500,"Census Tract 5, Clare County, Michigan",628,509,0,453,56,119
1400000US26035000600,"Census Tract 6, Clare County, Michigan",1608,1363,12,1153,198,245
1400000US26035000700,"Census Tract 7, Clare County, Michigan",1303,1117,0,925,192,186
1400000US26161403200,"Census Tract 4032, Washtenaw County, Michigan",1307,1276,0,1250,26,31
1400000US26161405200,"Census Tract 4052, Washtenaw County, Michigan",2266,2147,0,1976,171,119
1400000US26161406000,"Census Tract 4060, Washtenaw County, Michigan",1444,1403,1,1390,12,41
1400000US26111290300,"Census Tract 2903, Midland County, Michigan",1659,1572,10,1520,42,87
1400000US26111291500,"Census Tract 2915, Midland County, Michigan",1586,1277,0,1135,142,309
1400000US26111291700,"Census Tract 2917, Midland County, Michigan",1753,1340,15,1164,161,413
1400000US26111290600,"Census Tract 2906, Midland County, Michigan",989,755,0,620,135,234
1400000US26111290700,"Census Tract 2907, Midland County, Michigan",1664,1531,0,1393,138,133
1400000US26111290500,"Census Tract 2905, Midland County, Michigan",760,690,0,674,16,70
1400000US26111290900,"Census Tract 2909, Midland County, Michigan",3056,2966,0,2847,119,90
1400000US26111291000,"Census Tract 2910, Midland County, Michigan",2647,2392,0,2217,175,255
1400000US26111290400,"Census Tract 2904, Midland County, Michigan",694,625,0,590,35,69
1400000US26111291300,"Census Tract 2913, Midland County, Michigan",1683,1460,12,1250,198,223
1400000US26111290100,"Census Tract 2901, Midland County, Michigan",1481,1223,9,1032,182,258
1400000US26111290200,"Census Tract 2902, Midland County, Michigan",1986,1597,82,1356,159,389
1400000US26111291102,"Census Tract 2911.02, Midland County, Michigan",3749,3377,47,3080,250,372
1400000US26111291101,"Census Tract 2911.01, Midland County, Michigan",1464,1253,25,1081,147,211
1400000US26111291400,"Census Tract 2914, Midland County, Michigan",1506,1187,36,962,189,319
1400000US26111290800,"Census Tract 2908, Midland County, Michigan",2114,2072,0,1993,79,42
1400000US26111291200,"Census Tract 2912, Midland County, Michigan",2234,1928,0,1892,36,306
1400000US26021020300,"Census Tract 203, Berrien County, Michigan",1094,1022,17,855,150,72
1400000US26021021000,"Census Tract 210, Berrien County, Michigan",2072,1813,0,1458,355,259
1400000US26021021100,"Census Tract 211, Berrien County, Michigan",785,712,0,680,32,73
1400000US26021021200,"Census Tract 212, Berrien County, Michigan",661,509,0,419,90,152
1400000US26021000400,"Census Tract 4, Berrien County, Michigan",1258,872,0,560,312,386
1400000US26021001400,"Census Tract 14, Berrien County, Michigan",1758,1568,8,1416,144,190
1400000US26021001900,"Census Tract 19, Berrien County, Michigan",809,616,15,517,84,193
1400000US26021001100,"Census Tract 11, Berrien County, Michigan",1641,1526,0,1448,78,115
1400000US26021001600,"Census Tract 16, Berrien County, Michigan",908,848,5,791,52,60
1400000US26109960600,"Census Tract 9606, Menominee County, Michigan",1884,1576,0,1429,147,308
1400000US26109960500,"Census Tract 9605, Menominee County, Michigan",1489,1265,26,1028,211,224
1400000US26109960700,"Census Tract 9607, Menominee County, Michigan",1585,1174,6,1032,136,411
1400000US26109960300,"Census Tract 9603, Menominee County, Michigan",1052,842,0,724,118,210
1400000US26109960100,"Census Tract 9601, Menominee County, Michigan",1428,1169,17,1042,110,259
1400000US26125183900,"Census Tract 1839, Oakland County, Michigan",1217,1151,0,1073,78,66
1400000US26125190700,"Census Tract 1907, Oakland County, Michigan",1608,1548,0,1509,39,60
1400000US26125191300,"Census Tract 1913, Oakland County, Michigan",1404,1404,0,1373,31,0
1400000US26125193300,"Census Tract 1933, Oakland County, Michigan",2056,1877,24,1688,165,179
1400000US26125196100,"Census Tract 1961, Oakland County, Michigan",2183,2132,31,2062,39,51
1400000US26125196200,"Census Tract 1962, Oakland County, Michigan",1439,1372,0,1297,75,67
1400000US26125196800,"Census Tract 1968, Oakland County, Michigan",1610,1513,0,1500,13,97
1400000US26125197900,"Census Tract 1979, Oakland County, Michigan",1178,1150,0,1104,46,28
1400000US26125141600,"Census Tract 1416, Oakland County, Michigan",1500,1225,28,1087,110,275
1400000US26125142300,"Census Tract 1423, Oakland County, Michigan",1061,734,8,594,132,327
1400000US26125142500,"Census Tract 1425, Oakland County, Michigan",864,762,0,694,68,102
1400000US26125142700,"Census Tract 1427, Oakland County, Michigan",1634,1232,0,1000,232,402
1400000US26125144600,"Census Tract 1446, Oakland County, Michigan",1569,1446,0,1358,88,123
1400000US26125145600,"Census Tract 1456, Oakland County, Michigan",1888,1756,0,1635,121,132
1400000US26125150300,"Census Tract 1503, Oakland County, Michigan",1936,1867,0,1830,37,69
1400000US26125150400,"Census Tract 1504, Oakland County, Michigan",977,918,4,914,0,59
1400000US26125150800,"Census Tract 1508, Oakland County, Michigan",1663,1573,0,1544,29,90
1400000US26125152600,"Census Tract 1526, Oakland County, Michigan",1522,1507,0,1417,90,15
1400000US26125153200,"Census Tract 1532, Oakland County, Michigan",1049,1001,0,944,57,48
1400000US26125154100,"Census Tract 1541, Oakland County, Michigan",1146,1102,0,1027,75,44
1400000US26125154600,"Census Tract 1546, Oakland County, Michigan",981,922,0,922,0,59
1400000US26125156300,"Census Tract 1563, Oakland County, Michigan",1513,1490,0,1482,8,23
1400000US26125140100,"Census Tract 1401, Oakland County, Michigan",479,449,0,407,42,30
1400000US26033971100,"Census Tract 9711, Chippewa County, Michigan",790,648,32,561,55,142
1400000US26125136500,"Census Tract 1365, Oakland County, Michigan",2162,2074,13,1956,105,88
1400000US26125137400,"Census Tract 1374, Oakland County, Michigan",1998,1979,0,1933,46,19
1400000US26125138600,"Census Tract 1386, Oakland County, Michigan",816,778,0,752,26,38
1400000US26033971000,"Census Tract 9710, Chippewa County, Michigan",1224,1014,22,858,134,210
1400000US26033970400,"Census Tract 9704, Chippewa County, Michigan",1045,860,8,793,59,185
1400000US26033970700,"Census Tract 9707, Chippewa County, Michigan",470,366,14,285,67,104
1400000US26033970100,"Census Tract 9701, Chippewa County, Michigan",1208,1065,9,979,77,143
1400000US26033970300,"Census Tract 9703, Chippewa County, Michigan",1646,1307,13,1077,217,339
1400000US26033970900,"Census Tract 9709, Chippewa County, Michigan",1105,946,4,838,104,159
1400000US26033970500,"Census Tract 9705, Chippewa County, Michigan",1646,1354,0,1165,189,292
1400000US26033970600,"Census Tract 9706, Chippewa County, Michigan",1980,1711,10,1608,93,269
1400000US26033970200,"Census Tract 9702, Chippewa County, Michigan",1398,1216,0,1078,138,182
1400000US26033970800,"Census Tract 9708, Chippewa County, Michigan",1534,1303,18,1168,117,231
1400000US26115830300,"Census Tract 8303, Monroe County, Michigan",1506,1325,31,1173,121,181
1400000US26115832100,"Census Tract 8321, Monroe County, Michigan",1294,1058,0,868,190,236
1400000US26115833600,"Census Tract 8336, Monroe County, Michigan",1172,1031,0,893,138,141
1400000US26115833700,"Census Tract 8337, Monroe County, Michigan",1136,1002,0,891,111,134
1400000US26115833800,"Census Tract 8338, Monroe County, Michigan",2072,1936,21,1756,159,136
1400000US26115830500,"Census Tract 8305, Monroe County, Michigan",1289,1183,11,1030,142,106
1400000US26115831000,"Census Tract 8310, Monroe County, Michigan",1127,1046,0,1011,35,81
1400000US26115832600,"Census Tract 8326, Monroe County, Michigan",819,743,5,690,48,76
1400000US26163524800,"Census Tract 5248, Wayne County, Michigan",1084,769,0,468,301,315
1400000US26163526100,"Census Tract 5261, Wayne County, Michigan",789,628,0,402,226,161
1400000US26163526300,"Census Tract 5263, Wayne County, Michigan",1060,805,0,628,177,255
1400000US26163534300,"Census Tract 5343, Wayne County, Michigan",604,468,0,352,116,136
1400000US26163535100,"Census Tract 5351, Wayne County, Michigan",653,471,0,352,119,182
1400000US26163535700,"Census Tract 5357, Wayne County, Michigan",435,324,8,187,129,111
1400000US26163536100,"Census Tract 5361, Wayne County, Michigan",1290,1002,0,743,259,288
1400000US26163538200,"Census Tract 5382, Wayne County, Michigan",788,771,8,679,84,17
1400000US26163540100,"Census Tract 5401, Wayne County, Michigan",1215,1045,0,782,263,170
1400000US26163567900,"Census Tract 5679, Wayne County, Michigan",1250,1129,0,1101,28,121
1400000US26163569500,"Census Tract 5695, Wayne County, Michigan",1053,985,0,925,60,68
1400000US26163572700,"Census Tract 5727, Wayne County, Michigan",1758,1564,0,1347,217,194
1400000US26163573500,"Census Tract 5735, Wayne County, Michigan",1053,862,0,670,192,191
1400000US26163574100,"Census Tract 5741, Wayne County, Michigan",1190,1038,0,768,270,152
1400000US26163575000,"Census Tract 5750, Wayne County, Michigan",1785,1494,16,1268,210,291
1400000US26163565600,"Census Tract 5656, Wayne County, Michigan",798,753,11,732,10,45
1400000US26163566800,"Census Tract 5668, Wayne County, Michigan",1096,982,0,840,142,114
1400000US26163536200,"Census Tract 5362, Wayne County, Michigan",802,701,0,539,162,101
1400000US26163533500,"Census Tract 5335, Wayne County, Michigan",453,310,0,221,89,143
1400000US26163535500,"Census Tract 5355, Wayne County, Michigan",1248,1040,0,867,173,208
1400000US26099263400,"Census Tract 2634, Macomb County, Michigan",1340,1127,6,1062,59,213
1400000US26099216000,"Census Tract 2160, Macomb County, Michigan",1598,1322,21,1176,125,276
1400000US26099230000,"Census Tract 2300, Macomb County, Michigan",2375,1805,0,1687,118,570
1400000US26099241700,"Census Tract 2417, Macomb County, Michigan",1846,1540,0,1442,98,306
1400000US26099261800,"Census Tract 2618, Macomb County, Michigan",1111,976,0,957,19,135
1400000US26099251400,"Census Tract 2514, Macomb County, Michigan",1244,1068,14,983,71,176
1400000US26099256700,"Census Tract 2567, Macomb County, Michigan",672,591,0,518,73,81
1400000US26099254100,"Census Tract 2541, Macomb County, Michigan",1851,1653,0,1465,188,198
1400000US26163553100,"Census Tract 5531, Wayne County, Michigan",597,465,0,351,114,132
1400000US26163553300,"Census Tract 5533, Wayne County, Michigan",462,267,0,143,124,195
1400000US26163554300,"Census Tract 5543, Wayne County, Michigan",1976,1809,0,1484,325,167
1400000US26163513200,"Census Tract 5132, Wayne County, Michigan",656,579,0,436,143,77
1400000US26163507500,"Census Tract 5075, Wayne County, Michigan",859,553,0,323,230,306
1400000US26163508000,"Census Tract 5080, Wayne County, Michigan",661,433,0,185,248,228
1400000US26163514500,"Census Tract 5145, Wayne County, Michigan",416,326,0,231,95,90
1400000US26163515200,"Census Tract 5152, Wayne County, Michigan",625,585,12,481,92,40
1400000US26109960400,"Census Tract 9604, Menominee County, Michigan",1606,1350,36,1165,149,256
1400000US26113960100,"Census Tract 9601, Missaukee County, Michigan",1674,1321,42,1100,179,353
1400000US26113960400,"Census Tract 9604, Missaukee County, Michigan",1136,976,17,847,112,160
1400000US26113960200,"Census Tract 9602, Missaukee County, Michigan",1354,1165,6,981,178,189
1400000US26113960300,"Census Tract 9603, Missaukee County, Michigan",1863,1590,8,1324,258,273
1400000US26149040700,"Census Tract 407, St. Joseph County, Michigan",1172,1033,19,845,169,139
1400000US26149041600,"Census Tract 416, St. Joseph County, Michigan",1296,978,7,843,128,318
1400000US26149040900,"Census Tract 409, St. Joseph County, Michigan",1677,1457,29,1310,118,220
1400000US26149040200,"Census Tract 402, St. Joseph County, Michigan",659,535,7,442,86,124
1400000US26149041500,"Census Tract 415, St. Joseph County, Michigan",1837,1605,0,1427,178,232
1400000US26149040300,"Census Tract 403, St. Joseph County, Michigan",1231,1129,0,978,151,102
1400000US26149040600,"Census Tract 406, St. Joseph County, Michigan",1259,1053,0,942,111,206
1400000US26149040400,"Census Tract 404, St. Joseph County, Michigan",932,784,18,631,135,148
1400000US26149040800,"Census Tract 408, St. Joseph County, Michigan",1418,1085,0,1001,84,333
1400000US26149041200,"Census Tract 412, St. Joseph County, Michigan",1176,986,27,818,141,190
1400000US26149041300,"Census Tract 413, St. Joseph County, Michigan",2648,2040,14,1830,196,608
1400000US26049001100,"Census Tract 11, Genesee County, Michigan",737,418,0,246,172,319
1400000US26049001500,"Census Tract 15, Genesee County, Michigan",390,328,7,239,82,62
1400000US26049001700,"Census Tract 17, Genesee County, Michigan",701,400,6,291,103,301
1400000US26049001800,"Census Tract 18, Genesee County, Michigan",680,544,0,314,230,136
1400000US26049003100,"Census Tract 31, Genesee County, Michigan",1057,838,5,632,201,219
1400000US26049003300,"Census Tract 33, Genesee County, Michigan",873,707,0,602,105,166
1400000US26049010110,"Census Tract 101.10, Genesee County, Michigan",1348,1040,0,826,214,308
1400000US26049010504,"Census Tract 105.04, Genesee County, Michigan",1747,1449,9,1187,253,298
1400000US26049010912,"Census Tract 109.12, Genesee County, Michigan",1366,1169,19,1069,81,197
1400000US26049011010,"Census Tract 110.10, Genesee County, Michigan",2303,1959,0,1871,88,344
1400000US26049011214,"Census Tract 112.14, Genesee County, Michigan",2242,2150,0,2063,87,92
1400000US26049011610,"Census Tract 116.10, Genesee County, Michigan",2907,2789,0,2446,343,118
1400000US26049011800,"Census Tract 118, Genesee County, Michigan",1244,1110,0,1046,64,134
1400000US26049012006,"Census Tract 120.06, Genesee County, Michigan",1060,841,0,767,74,219
1400000US26049012007,"Census Tract 120.07, Genesee County, Michigan",625,560,0,515,45,65
1400000US26049012009,"Census Tract 120.09, Genesee County, Michigan",923,853,14,744,95,70
1400000US26049012202,"Census Tract 122.02, Genesee County, Michigan",484,330,0,245,85,154
1400000US26049010111,"Census Tract 101.11, Genesee County, Michigan",491,441,7,413,21,50
1400000US26049013204,"Census Tract 132.04, Genesee County, Michigan",2673,2426,16,2260,150,247
1400000US26049013111,"Census Tract 131.11, Genesee County, Michigan",1149,1004,0,943,61,145
1400000US26049003700,"Census Tract 37, Genesee County, Michigan",1201,928,0,727,201,273
1400000US26049010810,"Census Tract 108.10, Genesee County, Michigan",1899,1727,8,1561,158,172
1400000US26049011211,"Census Tract 112.11, Genesee County, Michigan",2294,2088,11,1837,240,206
1400000US26049000700,"Census Tract 7, Genesee County, Michigan",1000,620,9,380,231,380
1400000US26049002600,"Census Tract 26, Genesee County, Michigan",1211,1030,13,710,307,181
1400000US26049010305,"Census Tract 103.05, Genesee County, Michigan",1782,1453,26,1104,323,329
1400000US26049010503,"Census Tract 105.03, Genesee County, Michigan",906,807,0,750,57,99
1400000US26049013110,"Census Tract 131.10, Genesee County, Michigan",781,753,0,705,48,28
1400000US26049011505,"Census Tract 115.05, Genesee County, Michigan",938,826,0,777,49,112
1400000US26049012008,"Census Tract 120.08, Genesee County, Michigan",1167,1049,0,1010,39,118
1400000US26049012201,"Census Tract 122.01, Genesee County, Michigan",1173,879,0,635,244,294
1400000US26049012802,"Census Tract 128.02, Genesee County, Michigan",741,651,0,614,37,90
1400000US26049013301,"Census Tract 133.01, Genesee County, Michigan",2522,2282,15,2164,103,240
1400000US26049013401,"Census Tract 134.01, Genesee County, Michigan",2133,2069,30,1950,89,64
1400000US26049013202,"Census Tract 132.02, Genesee County, Michigan",2574,2290,0,2035,255,284
1400000US26049000800,"Census Tract 8, Genesee County, Michigan",442,300,0,226,74,142
1400000US26049001200,"Census Tract 12, Genesee County, Michigan",1270,963,0,770,193,307
1400000US26077002905,"Census Tract 29.05, Kalamazoo County, Michigan",3774,3316,29,3113,174,458
1400000US26077002801,"Census Tract 28.01, Kalamazoo County, Michigan",1683,1489,0,1287,202,194
1400000US26077002903,"Census Tract 29.03, Kalamazoo County, Michigan",2915,2492,32,2223,237,423
1400000US26077003004,"Census Tract 30.04, Kalamazoo County, Michigan",2707,2707,0,2621,86,0
1400000US26077000202,"Census Tract 2.02, Kalamazoo County, Michigan",342,265,4,246,15,77
1400000US26077001100,"Census Tract 11, Kalamazoo County, Michigan",765,680,0,633,47,85
1400000US26077001506,"Census Tract 15.06, Kalamazoo County, Michigan",3439,3241,15,2685,541,198
1400000US26077001601,"Census Tract 16.01, Kalamazoo County, Michigan",1194,1124,0,1085,39,70
1400000US26077000201,"Census Tract 2.01, Kalamazoo County, Michigan",862,732,0,658,74,130
1400000US26077001000,"Census Tract 10, Kalamazoo County, Michigan",2101,1794,0,1748,46,307
1400000US26077001502,"Census Tract 15.02, Kalamazoo County, Michigan",2130,1894,17,1718,159,236
1400000US26077001507,"Census Tract 15.07, Kalamazoo County, Michigan",2315,2167,0,1837,330,148
1400000US26077001604,"Census Tract 16.04, Kalamazoo County, Michigan",893,841,0,822,19,52
1400000US26077001907,"Census Tract 19.07, Kalamazoo County, Michigan",1782,1453,14,1412,27,329
1400000US26077002005,"Census Tract 20.05, Kalamazoo County, Michigan",1592,1443,0,1355,88,149
1400000US26077002700,"Census Tract 27, Kalamazoo County, Michigan",3072,2845,15,2716,114,227
1400000US26077002802,"Census Tract 28.02, Kalamazoo County, Michigan",2360,2213,13,2060,140,147
1400000US26077002201,"Census Tract 22.01, Kalamazoo County, Michigan",871,747,0,639,108,124
1400000US26077000300,"Census Tract 3, Kalamazoo County, Michigan",1491,1099,0,961,138,392
1400000US26077000600,"Census Tract 6, Kalamazoo County, Michigan",2135,1891,0,1695,196,244
1400000US26077001603,"Census Tract 16.03, Kalamazoo County, Michigan",727,673,0,622,51,54
1400000US26077001702,"Census Tract 17.02, Kalamazoo County, Michigan",1663,1521,15,1409,97,142
1400000US26077002003,"Census Tract 20.03, Kalamazoo County, Michigan",2307,2172,0,2115,57,135
1400000US26077002004,"Census Tract 20.04, Kalamazoo County, Michigan",1599,1543,19,1445,79,56
1400000US26145010200,"Census Tract 102, Saginaw County, Michigan",1165,1037,0,872,165,128
1400000US26077001200,"Census Tract 12, Kalamazoo County, Michigan",1223,1152,0,1127,25,71
1400000US26145000100,"Census Tract 1, Saginaw County, Michigan",306,240,0,222,18,66
1400000US26145000900,"Census Tract 9, Saginaw County, Michigan",1340,800,0,649,151,540
1400000US26145010502,"Census Tract 105.02, Saginaw County, Michigan",2677,2267,16,2037,214,410
1400000US26145010800,"Census Tract 108, Saginaw County, Michigan",1001,843,0,762,81,158
1400000US26145011300,"Census Tract 113, Saginaw County, Michigan",3084,2681,22,2511,148,403
1400000US26145011702,"Census Tract 117.02, Saginaw County, Michigan",937,831,0,775,56,106
1400000US26145000800,"Census Tract 8, Saginaw County, Michigan",1042,780,0,540,240,262
1400000US26145011800,"Census Tract 118, Saginaw County, Michigan",859,704,0,653,51,155
1400000US26145012200,"Census Tract 122, Saginaw County, Michigan",645,554,0,470,84,91
1400000US26145013000,"Census Tract 130, Saginaw County, Michigan",1597,1378,14,1271,93,219
1400000US26145002100,"Census Tract 21, Saginaw County, Michigan",1864,1608,0,1448,160,256
1400000US26145010100,"Census Tract 101, Saginaw County, Michigan",3229,2989,13,2936,40,240
1400000US26145010302,"Census Tract 103.02, Saginaw County, Michigan",2999,2741,0,2588,153,258
1400000US26145000200,"Census Tract 2, Saginaw County, Michigan",573,466,0,420,46,107
1400000US26145002000,"Census Tract 20, Saginaw County, Michigan",1468,1236,18,1052,166,232
1400000US26145000700,"Census Tract 7, Saginaw County, Michigan",650,345,0,291,54,305
1400000US26145000400,"Census Tract 4, Saginaw County, Michigan",442,302,0,236,66,140
1400000US26145001100,"Census Tract 11, Saginaw County, Michigan",1116,916,0,768,148,200
1400000US26145001500,"Census Tract 15, Saginaw County, Michigan",1634,1446,0,1341,105,188
1400000US26145001800,"Census Tract 18, Saginaw County, Michigan",675,507,0,420,87,168
1400000US26145001900,"Census Tract 19, Saginaw County, Michigan",610,428,0,394,34,182
1400000US26145010303,"Census Tract 103.03, Saginaw County, Michigan",1574,1285,0,1226,59,289
1400000US26145010304,"Census Tract 103.04, Saginaw County, Michigan",2290,1992,0,1884,108,298
1400000US26145010401,"Census Tract 104.01, Saginaw County, Michigan",1126,922,23,854,45,204
1400000US26145011000,"Census Tract 110, Saginaw County, Michigan",2652,1880,0,1566,314,772
1400000US26145011901,"Census Tract 119.01, Saginaw County, Michigan",773,682,0,660,22,91
1400000US26145012002,"Census Tract 120.02, Saginaw County, Michigan",1431,1334,7,1283,44,97
1400000US26145011500,"Census Tract 115, Saginaw County, Michigan",1138,836,0,707,129,302
1400000US26145011600,"Census Tract 116, Saginaw County, Michigan",1407,1200,0,1074,126,207
1400000US26145012001,"Census Tract 120.01, Saginaw County, Michigan",1358,1218,0,1079,139,140
1400000US26145012003,"Census Tract 120.03, Saginaw County, Michigan",2050,1759,29,1531,199,291
1400000US26081012300,"Census Tract 123, Kent County, Michigan",1280,1268,0,1167,101,12
1400000US26081012703,"Census Tract 127.03, Kent County, Michigan",1596,1486,10,1372,104,110
1400000US26081012800,"Census Tract 128, Kent County, Michigan",1528,1406,0,1335,71,122
1400000US26081013200,"Census Tract 132, Kent County, Michigan",2679,2328,17,2188,123,351
1400000US26081014100,"Census Tract 141, Kent County, Michigan",709,650,0,524,126,59
1400000US26081014200,"Census Tract 142, Kent County, Michigan",1354,1140,0,1019,121,214
1400000US26081000100,"Census Tract 1, Kent County, Michigan",944,847,6,768,73,97
1400000US26081000500,"Census Tract 5, Kent County, Michigan",1646,1522,8,1400,114,124
1400000US26081001700,"Census Tract 17, Kent County, Michigan",1920,1665,0,1518,147,255
1400000US26081002300,"Census Tract 23, Kent County, Michigan",1677,1554,6,1503,45,123
1400000US26081002400,"Census Tract 24, Kent County, Michigan",865,827,0,791,36,38
1400000US26081002800,"Census Tract 28, Kent County, Michigan",665,483,0,353,130,182
1400000US26081004000,"Census Tract 40, Kent County, Michigan",984,779,0,643,136,205
1400000US26081001000,"Census Tract 10, Kent County, Michigan",1856,1575,9,1483,83,281
1400000US26081001500,"Census Tract 15, Kent County, Michigan",1351,1126,0,1060,66,225
1400000US26081003300,"Census Tract 33, Kent County, Michigan",1351,1216,8,1157,51,135
1400000US26081010101,"Census Tract 101.01, Kent County, Michigan",2148,1957,50,1650,257,191
1400000US26081010401,"Census Tract 104.01, Kent County, Michigan",1730,1531,8,1318,205,199
1400000US26081010402,"Census Tract 104.02, Kent County, Michigan",1580,1278,0,1171,107,302
1400000US26081011301,"Census Tract 113.01, Kent County, Michigan",1929,1820,10,1715,95,109
1400000US26081012201,"Census Tract 122.01, Kent County, Michigan",2679,2510,0,2362,148,169
1400000US26081012202,"Census Tract 122.02, Kent County, Michigan",2400,2330,20,2291,19,70
1400000US26081012400,"Census Tract 124, Kent County, Michigan",1401,1401,0,1369,32,0
1400000US26081012702,"Census Tract 127.02, Kent County, Michigan",1527,1449,0,1388,61,78
1400000US26081013400,"Census Tract 134, Kent County, Michigan",2056,1856,10,1665,181,200
1400000US26081013900,"Census Tract 139, Kent County, Michigan",2656,2496,33,2250,213,160
1400000US26081014300,"Census Tract 143, Kent County, Michigan",1072,1013,0,910,103,59
1400000US26081001400,"Census Tract 14, Kent County, Michigan",1120,1079,0,1042,37,41
1400000US26081002000,"Census Tract 20, Kent County, Michigan",1454,1229,0,999,230,225
1400000US26081002600,"Census Tract 26, Kent County, Michigan",1029,840,0,701,139,189
1400000US26163575100,"Census Tract 5751, Wayne County, Michigan",978,918,0,842,76,60
1400000US26163580800,"Census Tract 5808, Wayne County, Michigan",621,560,7,469,84,61
1400000US26163581600,"Census Tract 5816, Wayne County, Michigan",2563,2211,17,1920,274,352
1400000US26163583200,"Census Tract 5832, Wayne County, Michigan",947,751,0,644,107,196
1400000US26163546000,"Census Tract 5460, Wayne County, Michigan",1152,941,0,670,271,211
1400000US26163546400,"Census Tract 5464, Wayne County, Michigan",451,416,0,241,175,35
1400000US26163501200,"Census Tract 5012, Wayne County, Michigan",511,357,0,188,169,154
1400000US26163503100,"Census Tract 5031, Wayne County, Michigan",1037,875,13,691,171,162
1400000US26163503200,"Census Tract 5032, Wayne County, Michigan",968,891,0,618,273,77
1400000US26163503400,"Census Tract 5034, Wayne County, Michigan",473,339,0,233,106,134
1400000US26163505200,"Census Tract 5052, Wayne County, Michigan",1188,1077,0,716,361,111
1400000US26163506800,"Census Tract 5068, Wayne County, Michigan",1597,1196,23,707,466,401
1400000US26163557300,"Census Tract 5573, Wayne County, Michigan",831,794,5,765,24,37
1400000US26163557000,"Census Tract 5570, Wayne County, Michigan",1214,1082,9,1016,57,132
1400000US26163558400,"Census Tract 5584, Wayne County, Michigan",1594,1531,0,1449,82,63
1400000US26163558900,"Census Tract 5589, Wayne County, Michigan",706,669,0,661,8,37
1400000US26163559200,"Census Tract 5592, Wayne County, Michigan",831,766,0,710,56,65
1400000US26163561600,"Census Tract 5616, Wayne County, Michigan",1820,1479,21,1396,62,341
1400000US26163563800,"Census Tract 5638, Wayne County, Michigan",1095,1053,0,1021,32,42
1400000US26163591700,"Census Tract 5917, Wayne County, Michigan",2481,2298,0,2218,80,183
1400000US26163594300,"Census Tract 5943, Wayne County, Michigan",1239,1121,11,1028,82,118
1400000US26163594400,"Census Tract 5944, Wayne County, Michigan",1195,1026,12,922,92,169
1400000US26163552200,"Census Tract 5522, Wayne County, Michigan",1021,882,0,743,139,139
1400000US26163594200,"Census Tract 5942, Wayne County, Michigan",1016,907,5,854,48,109
1400000US26163589400,"Census Tract 5894, Wayne County, Michigan",2154,2094,79,1733,282,60
1400000US26163591900,"Census Tract 5919, Wayne County, Michigan",2055,1940,0,1840,100,115
1400000US26163594000,"Census Tract 5940, Wayne County, Michigan",1294,1105,0,963,142,189
1400000US26163554900,"Census Tract 5549, Wayne County, Michigan",1223,1141,0,1085,56,82
1400000US26163556200,"Census Tract 5562, Wayne County, Michigan",1348,1022,10,928,84,326
1400000US26163553000,"Census Tract 5530, Wayne County, Michigan",495,369,0,223,146,126
1400000US26163553600,"Census Tract 5536, Wayne County, Michigan",889,710,15,487,208,179
1400000US26163556700,"Census Tract 5567, Wayne County, Michigan",981,857,0,818,39,124
1400000US26163557700,"Census Tract 5577, Wayne County, Michigan",1698,1474,15,1390,69,224
1400000US26077001905,"Census Tract 19.05, Kalamazoo County, Michigan",2536,2079,15,1818,246,457
1400000US26077002002,"Census Tract 20.02, Kalamazoo County, Michigan",1700,1603,9,1522,72,97
1400000US26077002901,"Census Tract 29.01, Kalamazoo County, Michigan",1502,1367,7,1297,63,135
1400000US26077003003,"Census Tract 30.03, Kalamazoo County, Michigan",3096,3080,29,2956,95,16
1400000US26077003302,"Census Tract 33.02, Kalamazoo County, Michigan",2525,2196,0,2079,117,329
1400000US26021010500,"Census Tract 105, Berrien County, Michigan",863,675,14,581,80,188
1400000US26021011000,"Census Tract 110, Berrien County, Michigan",1224,1078,7,944,127,146
1400000US26021011100,"Census Tract 111, Berrien County, Michigan",2491,2099,19,1754,326,392
1400000US26021011500,"Census Tract 115, Berrien County, Michigan",584,503,11,432,60,81
1400000US26021020200,"Census Tract 202, Berrien County, Michigan",2204,1856,0,1595,261,348
1400000US26021020700,"Census Tract 207, Berrien County, Michigan",1166,891,0,757,134,275
1400000US26021021300,"Census Tract 213, Berrien County, Michigan",1166,1089,8,902,179,77
1400000US26021001800,"Census Tract 18, Berrien County, Michigan",1687,1523,8,1360,155,164
1400000US26021002000,"Census Tract 20, Berrien County, Michigan",1580,1302,8,1032,262,278
1400000US26021002500,"Census Tract 25, Berrien County, Michigan",937,783,16,629,138,154
1400000US26021010200,"Census Tract 102, Berrien County, Michigan",2748,2352,16,1891,445,396
1400000US26021000900,"Census Tract 9, Berrien County, Michigan",1048,987,7,880,100,61
1400000US26021001000,"Census Tract 10, Berrien County, Michigan",872,799,0,711,88,73
1400000US26021001300,"Census Tract 13, Berrien County, Michigan",957,876,9,801,66,81
1400000US26021011600,"Census Tract 116, Berrien County, Michigan",840,724,15,592,117,116
1400000US26021020900,"Census Tract 209, Berrien County, Michigan",1364,1210,10,948,252,154
1400000US26021021400,"Census Tract 214, Berrien County, Michigan",1521,1365,6,1142,217,156
1400000US26021000700,"Census Tract 7, Berrien County, Michigan",1277,1101,9,967,125,176
1400000US26021001500,"Census Tract 15, Berrien County, Michigan",1534,1331,24,1206,101,203
1400000US26021002300,"Census Tract 23, Berrien County, Michigan",759,582,7,351,224,177
1400000US26021010100,"Census Tract 101, Berrien County, Michigan",1635,1434,20,1126,288,201
1400000US26021010600,"Census Tract 106, Berrien County, Michigan",1778,1703,41,1405,257,75
1400000US26021011200,"Census Tract 112, Berrien County, Michigan",1494,1397,0,1110,287,97
1400000US26021000300,"Census Tract 3, Berrien County, Michigan",744,547,0,425,122,197
1400000US26021000500,"Census Tract 5, Berrien County, Michigan",567,370,0,289,81,197
1400000US26021000800,"Census Tract 8, Berrien County, Michigan",2624,2391,15,2097,279,233
1400000US26021002400,"Census Tract 24, Berrien County, Michigan",745,611,16,480,115,134
1400000US26021011300,"Census Tract 113, Berrien County, Michigan",1897,1677,10,1530,137,220
1400000US26021011400,"Census Tract 114, Berrien County, Michigan",1092,942,12,821,109,150
1400000US26021020100,"Census Tract 201, Berrien County, Michigan",1001,946,0,820,126,55
1400000US26021000600,"Census Tract 6, Berrien County, Michigan",1399,1127,0,852,275,272
1400000US26021002200,"Census Tract 22, Berrien County, Michigan",1053,757,0,476,281,296
1400000US26021010400,"Census Tract 104, Berrien County, Michigan",1087,917,24,728,165,170
1400000US26021020400,"Census Tract 204, Berrien County, Michigan",1547,1415,0,1252,163,132
1400000US26021020500,"Census Tract 205, Berrien County, Michigan",1328,1039,7,818,214,289
1400000US26149040100,"Census Tract 401, St. Joseph County, Michigan",1337,1223,0,1201,22,114
1400000US26021010300,"Census Tract 103, Berrien County, Michigan",1968,1611,3,1389,219,357
1400000US26021020600,"Census Tract 206, Berrien County, Michigan",1381,1228,9,1172,47,153
1400000US26021002100,"Census Tract 21, Berrien County, Michigan",974,696,15,525,156,278
1400000US26149040500,"Census Tract 405, St. Joseph County, Michigan",1036,885,5,759,121,151
1400000US26149041400,"Census Tract 414, St. Joseph County, Michigan",2058,1794,18,1553,223,264
1400000US26149041000,"Census Tract 410, St. Joseph County, Michigan",1349,1151,8,1018,125,198
1400000US26147631600,"Census Tract 6316, St. Clair County, Michigan",1097,880,12,766,102,217
1400000US26147644000,"Census Tract 6440, St. Clair County, Michigan",1894,1666,23,1540,103,228
1400000US26147651100,"Census Tract 6511, St. Clair County, Michigan",731,618,0,582,36,113
1400000US26147637200,"Census Tract 6372, St. Clair County, Michigan",1615,1350,0,1282,68,265
1400000US26147657100,"Census Tract 6571, St. Clair County, Michigan",776,694,22,577,95,82
1400000US26147627000,"Census Tract 6270, St. Clair County, Michigan",1127,990,10,919,61,137
1400000US26147635000,"Census Tract 6350, St. Clair County, Michigan",2419,2174,30,2041,103,245
1400000US26147640100,"Census Tract 6401, St. Clair County, Michigan",856,796,7,739,50,60
1400000US26147640600,"Census Tract 6406, St. Clair County, Michigan",840,810,10,744,56,30
1400000US26147641000,"Census Tract 6410, St. Clair County, Michigan",1268,1184,10,1079,95,84
1400000US26147630100,"Census Tract 6301, St. Clair County, Michigan",621,504,0,467,37,117
1400000US26147636000,"Census Tract 6360, St. Clair County, Michigan",1629,1459,0,1357,102,170
1400000US26147655600,"Census Tract 6556, St. Clair County, Michigan",1212,1038,35,895,108,174
1400000US26147645000,"Census Tract 6450, St. Clair County, Michigan",1343,1127,10,972,145,216
1400000US26147648000,"Census Tract 6480, St. Clair County, Michigan",596,488,5,446,37,108
1400000US26147650100,"Census Tract 6501, St. Clair County, Michigan",1495,1367,0,1267,100,128
1400000US26147620000,"Census Tract 6200, St. Clair County, Michigan",1830,1661,0,1505,156,169
1400000US26147621000,"Census Tract 6210, St. Clair County, Michigan",1434,1269,16,1071,182,165
1400000US26147626000,"Census Tract 6260, St. Clair County, Michigan",886,726,0,665,61,160
1400000US26147629000,"Census Tract 6290, St. Clair County, Michigan",1351,1132,0,998,134,219
1400000US26147633100,"Census Tract 6331, St. Clair County, Michigan",1151,1031,9,987,35,120
1400000US26147637300,"Census Tract 6373, St. Clair County, Michigan",1092,952,0,860,92,140
1400000US26147642000,"Census Tract 6420, St. Clair County, Michigan",2322,1977,31,1797,149,345
1400000US26147646000,"Census Tract 6460, St. Clair County, Michigan",1903,1713,0,1634,79,190
1400000US26147657200,"Census Tract 6572, St. Clair County, Michigan",2004,1803,7,1547,249,201
1400000US26147658500,"Census Tract 6585, St. Clair County, Michigan",1390,1245,20,1092,133,145
1400000US26147622000,"Census Tract 6220, St. Clair County, Michigan",1559,1322,0,1255,67,237
1400000US26147624000,"Census Tract 6240, St. Clair County, Michigan",934,662,0,586,76,272
1400000US26147632000,"Census Tract 6320, St. Clair County, Michigan",1640,1492,60,1289,143,148
1400000US26147633200,"Census Tract 6332, St. Clair County, Michigan",1052,968,24,810,134,84
1400000US26147634100,"Census Tract 6341, St. Clair County, Michigan",1405,1254,19,1149,86,151
1400000US26147647000,"Census Tract 6470, St. Clair County, Michigan",1587,1439,13,1329,97,148
1400000US26049002800,"Census Tract 28, Genesee County, Michigan",697,576,0,514,62,121
1400000US26049003800,"Census Tract 38, Genesee County, Michigan",612,387,5,275,107,225
1400000US26049010604,"Census Tract 106.04, Genesee County, Michigan",1028,971,34,850,87,57
1400000US26049001300,"Census Tract 13, Genesee County, Michigan",1126,971,0,818,153,155
1400000US26049002400,"Census Tract 24, Genesee County, Michigan",1463,1211,0,1067,144,252
1400000US26049002900,"Census Tract 29, Genesee County, Michigan",1316,766,11,658,97,550
1400000US26049010501,"Census Tract 105.01, Genesee County, Michigan",998,818,0,585,233,180
1400000US26049003200,"Census Tract 32, Genesee County, Michigan",1003,615,0,431,184,388
1400000US26049003600,"Census Tract 36, Genesee County, Michigan",2327,2012,0,1640,372,315
1400000US26049010304,"Census Tract 103.04, Genesee County, Michigan",1321,1083,0,724,359,238
1400000US26163518600,"Census Tract 5186, Wayne County, Michigan",221,103,0,83,20,118
1400000US26163583300,"Census Tract 5833, Wayne County, Michigan",1005,881,0,684,197,124
1400000US26163584100,"Census Tract 5841, Wayne County, Michigan",673,595,11,537,47,78
1400000US26163584800,"Census Tract 5848, Wayne County, Michigan",2116,1787,0,1158,629,329
1400000US26163586200,"Census Tract 5862, Wayne County, Michigan",2310,2143,0,1869,274,167
1400000US26163587900,"Census Tract 5879, Wayne County, Michigan",2269,2123,0,1944,179,146
1400000US26163595100,"Census Tract 5951, Wayne County, Michigan",2130,2027,16,1829,182,103
1400000US26163599000,"Census Tract 5990, Wayne County, Michigan",1997,1928,18,1527,383,69
1400000US26163537700,"Census Tract 5377, Wayne County, Michigan",1104,761,0,351,410,343
1400000US26163538300,"Census Tract 5383, Wayne County, Michigan",1074,869,0,600,269,205
1400000US26163538400,"Census Tract 5384, Wayne County, Michigan",1436,1365,0,1176,189,71
1400000US26163539200,"Census Tract 5392, Wayne County, Michigan",2117,1723,18,1173,532,394
1400000US26163540600,"Census Tract 5406, Wayne County, Michigan",1222,1127,0,836,291,95
1400000US26163541000,"Census Tract 5410, Wayne County, Michigan",1762,1317,0,888,429,445
1400000US26163541300,"Census Tract 5413, Wayne County, Michigan",990,883,6,721,156,107
1400000US26163588100,"Census Tract 5881, Wayne County, Michigan",1011,917,8,700,209,94
1400000US26163577000,"Census Tract 5770, Wayne County, Michigan",1751,1307,0,1019,288,444
1400000US26009960400,"Census Tract 9604, Antrim County, Michigan",1348,1172,5,1003,164,176
1400000US26009960600,"Census Tract 9606, Antrim County, Michigan",1508,1386,9,1200,177,122
1400000US26009960100,"Census Tract 9601, Antrim County, Michigan",1151,1043,6,881,156,108
1400000US26009960700,"Census Tract 9607, Antrim County, Michigan",1845,1537,21,1311,205,308
1400000US26163558300,"Census Tract 5583, Wayne County, Michigan",766,682,7,640,35,84
1400000US26163558500,"Census Tract 5585, Wayne County, Michigan",1548,1438,0,1406,32,110
1400000US26163558700,"Census Tract 5587, Wayne County, Michigan",1021,970,0,962,8,51
1400000US26163560200,"Census Tract 5602, Wayne County, Michigan",2388,2216,14,2075,127,172
1400000US26163561900,"Census Tract 5619, Wayne County, Michigan",2321,2275,15,2196,64,46
1400000US26163564900,"Census Tract 5649, Wayne County, Michigan",749,712,0,541,171,37
1400000US26163565200,"Census Tract 5652, Wayne County, Michigan",2388,2130,14,2000,116,258
1400000US26163515400,"Census Tract 5154, Wayne County, Michigan",715,649,0,594,55,66
1400000US26163515700,"Census Tract 5157, Wayne County, Michigan",2703,2050,0,1722,328,653
1400000US26163516400,"Census Tract 5164, Wayne County, Michigan",399,332,0,319,13,67
1400000US26163517500,"Census Tract 5175, Wayne County, Michigan",1719,1157,11,915,231,562
1400000US26163518500,"Census Tract 5185, Wayne County, Michigan",351,301,0,211,90,50
1400000US26163523100,"Census Tract 5231, Wayne County, Michigan",561,397,0,288,109,164
1400000US26163524200,"Census Tract 5242, Wayne County, Michigan",1596,1230,0,934,296,366
1400000US26163526400,"Census Tract 5264, Wayne County, Michigan",400,314,0,231,83,86
1400000US26163530100,"Census Tract 5301, Wayne County, Michigan",1104,777,0,552,225,327
1400000US26163530800,"Census Tract 5308, Wayne County, Michigan",550,395,7,217,171,155
1400000US26163500400,"Census Tract 5004, Wayne County, Michigan",418,312,0,251,61,106
1400000US26163504100,"Census Tract 5041, Wayne County, Michigan",503,417,0,302,115,86
1400000US26163500800,"Census Tract 5008, Wayne County, Michigan",1025,884,6,660,218,141
1400000US26163501900,"Census Tract 5019, Wayne County, Michigan",866,716,5,526,185,150
1400000US26163506400,"Census Tract 5064, Wayne County, Michigan",290,221,1,138,82,69
1400000US26163502000,"Census Tract 5020, Wayne County, Michigan",673,614,4,425,185,59
1400000US26163504300,"Census Tract 5043, Wayne County, Michigan",661,560,0,403,157,101
1400000US26163505000,"Census Tract 5050, Wayne County, Michigan",354,276,0,194,82,78
1400000US26121002300,"Census Tract 23, Muskegon County, Michigan",2213,2078,33,1937,108,135
1400000US26121003900,"Census Tract 39, Muskegon County, Michigan",712,630,11,538,81,82
1400000US26121000100,"Census Tract 1, Muskegon County, Michigan",1836,1319,0,1074,245,517
1400000US26121001200,"Census Tract 12, Muskegon County, Michigan",797,657,0,537,120,140
1400000US26121001700,"Census Tract 17, Muskegon County, Michigan",1920,1666,16,1502,148,254
1400000US26121001800,"Census Tract 18, Muskegon County, Michigan",1754,1639,11,1429,199,115
1400000US26121002400,"Census Tract 24, Muskegon County, Michigan",1579,1224,8,1152,64,355
1400000US26121002800,"Census Tract 28, Muskegon County, Michigan",2395,2165,12,1979,174,230
1400000US26121000300,"Census Tract 3, Muskegon County, Michigan",1088,849,11,633,205,239
1400000US26121000800,"Census Tract 8, Muskegon County, Michigan",1373,1056,0,913,143,317
1400000US26121001402,"Census Tract 14.02, Muskegon County, Michigan",1534,1167,26,905,236,367
1400000US26121001902,"Census Tract 19.02, Muskegon County, Michigan",1960,1542,0,1450,92,418
1400000US26121002601,"Census Tract 26.01, Muskegon County, Michigan",1513,1244,0,1040,204,269
1400000US26121002700,"Census Tract 27, Muskegon County, Michigan",2854,2619,15,2506,98,235
1400000US26121002900,"Census Tract 29, Muskegon County, Michigan",2002,1765,59,1482,224,237
1400000US26121000900,"Census Tract 9, Muskegon County, Michigan",1596,1412,6,1256,150,184
1400000US26121001600,"Census Tract 16, Muskegon County, Michigan",1014,984,16,931,37,30
1400000US26121002000,"Census Tract 20, Muskegon County, Michigan",1594,1315,0,1191,124,279
1400000US26121002602,"Census Tract 26.02, Muskegon County, Michigan",1795,1623,33,1474,116,172
1400000US26121003300,"Census Tract 33, Muskegon County, Michigan",1996,1864,10,1480,374,132
1400000US26049010813,"Census Tract 108.13, Genesee County, Michigan",2091,1716,16,1570,130,375
1400000US26049011101,"Census Tract 111.01, Genesee County, Michigan",3369,3105,0,2978,127,264
1400000US26049011601,"Census Tract 116.01, Genesee County, Michigan",1177,1077,27,922,128,100
1400000US26049011710,"Census Tract 117.10, Genesee County, Michigan",1067,931,0,797,134,136
1400000US26049012311,"Census Tract 123.11, Genesee County, Michigan",700,566,0,503,63,134
1400000US26049012501,"Census Tract 125.01, Genesee County, Michigan",812,755,11,611,133,57
1400000US26049012904,"Census Tract 129.04, Genesee County, Michigan",2628,2424,0,2281,143,204
1400000US26049013001,"Census Tract 130.01, Genesee County, Michigan",922,854,0,790,64,68
1400000US26049013112,"Census Tract 131.12, Genesee County, Michigan",1583,1529,6,1471,52,54
1400000US26049010610,"Census Tract 106.10, Genesee County, Michigan",1989,1800,0,1718,82,189
1400000US26049011210,"Census Tract 112.10, Genesee County, Michigan",810,667,0,599,68,143
1400000US26049011401,"Census Tract 114.01, Genesee County, Michigan",1182,1029,26,906,97,153
1400000US26049012310,"Census Tract 123.10, Genesee County, Michigan",1236,1068,9,815,244,168
1400000US26049012704,"Census Tract 127.04, Genesee County, Michigan",1682,1584,44,1477,63,98
1400000US26049012801,"Census Tract 128.01, Genesee County, Michigan",1812,1645,11,1528,106,167
1400000US26049013113,"Census Tract 131.13, Genesee County, Michigan",1506,1373,8,1278,87,133
1400000US26049013402,"Census Tract 134.02, Genesee County, Michigan",664,634,2,593,39,30
1400000US26049000300,"Census Tract 3, Genesee County, Michigan",1137,768,21,468,279,369
1400000US26049000400,"Census Tract 4, Genesee County, Michigan",561,418,0,188,230,143
1400000US26049000500,"Census Tract 5, Genesee County, Michigan",742,554,0,403,151,188
1400000US26049001000,"Census Tract 10, Genesee County, Michigan",833,471,5,315,151,362
1400000US26049001600,"Census Tract 16, Genesee County, Michigan",1916,1563,33,1329,201,353
1400000US26049002300,"Census Tract 23, Genesee County, Michigan",697,611,14,390,207,86
1400000US26049001900,"Census Tract 19, Genesee County, Michigan",1055,786,5,548,233,269
1400000US26049002000,"Census Tract 20, Genesee County, Michigan",423,303,6,215,82,120
1400000US26049002200,"Census Tract 22, Genesee County, Michigan",748,544,0,407,137,204
1400000US26049002700,"Census Tract 27, Genesee County, Michigan",1541,1270,0,1134,136,271
1400000US26103002500,"Census Tract 25, Marquette County, Michigan",1043,841,0,771,70,202
1400000US26103000400,"Census Tract 4, Marquette County, Michigan",828,793,0,738,55,35
1400000US26103000600,"Census Tract 6, Marquette County, Michigan",965,863,5,682,176,102
1400000US26103001100,"Census Tract 11, Marquette County, Michigan",711,682,4,623,55,29
1400000US26103001300,"Census Tract 13, Marquette County, Michigan",1554,1408,9,1257,142,146
1400000US26103001900,"Census Tract 19, Marquette County, Michigan",708,569,0,470,99,139
1400000US26103002000,"Census Tract 20, Marquette County, Michigan",988,794,9,669,116,194
1400000US26103002200,"Census Tract 22, Marquette County, Michigan",1216,1059,0,981,78,157
1400000US26103001600,"Census Tract 16, Marquette County, Michigan",865,760,0,678,82,105
1400000US26123971000,"Census Tract 9710, Newaygo County, Michigan",1841,1597,14,1230,353,244
1400000US26123971200,"Census Tract 9712, Newaygo County, Michigan",1817,1557,25,1166,366,260
1400000US26123970300,"Census Tract 9703, Newaygo County, Michigan",1495,1144,21,935,188,351
1400000US26123970400,"Census Tract 9704, Newaygo County, Michigan",1918,1650,13,1398,239,268
1400000US26123970600,"Census Tract 9706, Newaygo County, Michigan",1570,1392,10,1150,232,178
1400000US26123970700,"Census Tract 9707, Newaygo County, Michigan",1593,1343,10,1076,257,250
1400000US26123970900,"Census Tract 9709, Newaygo County, Michigan",1721,1353,28,1034,291,368
1400000US26123970500,"Census Tract 9705, Newaygo County, Michigan",2048,1792,40,1511,241,256
1400000US26123970800,"Census Tract 9708, Newaygo County, Michigan",1464,1204,17,1007,180,260
1400000US26123970100,"Census Tract 9701, Newaygo County, Michigan",1859,1460,32,1105,323,399
1400000US26123971100,"Census Tract 9711, Newaygo County, Michigan",1681,1329,0,1175,154,352
1400000US26133970100,"Census Tract 9701, Osceola County, Michigan",1648,1294,29,989,276,354
1400000US26133970400,"Census Tract 9704, Osceola County, Michigan",1312,1013,6,839,168,299
1400000US26133970200,"Census Tract 9702, Osceola County, Michigan",1532,1278,16,996,266,254
1400000US26133970300,"Census Tract 9703, Osceola County, Michigan",1221,969,11,748,210,252
1400000US26133970500,"Census Tract 9705, Osceola County, Michigan",1611,1334,4,1071,259,277
1400000US26133970600,"Census Tract 9706, Osceola County, Michigan",1776,1483,12,1215,256,293
1400000US26137950300,"Census Tract 9503, Otsego County, Michigan",2384,1928,13,1678,237,456
1400000US26137950600,"Census Tract 9506, Otsego County, Michigan",1873,1725,40,1515,170,148
1400000US26137950100,"Census Tract 9501, Otsego County, Michigan",1130,966,10,814,142,164
1400000US26137950200,"Census Tract 9502, Otsego County, Michigan",2203,2061,14,1841,206,142
1400000US26137950400,"Census Tract 9504, Otsego County, Michigan",900,804,11,686,107,96
1400000US26137950500,"Census Tract 9505, Otsego County, Michigan",1396,1272,9,1186,77,124
1400000US26021001700,"Census Tract 17, Berrien County, Michigan",1786,1568,0,1462,106,218
1400000US26129950100,"Census Tract 9501, Ogemaw County, Michigan",1022,804,15,679,110,218
1400000US26129950300,"Census Tract 9503, Ogemaw County, Michigan",790,657,24,556,77,133
1400000US26129950600,"Census Tract 9506, Ogemaw County, Michigan",1089,853,8,698,147,236
1400000US26129950400,"Census Tract 9504, Ogemaw County, Michigan",1318,1118,6,988,124,200
1400000US26129950500,"Census Tract 9505, Ogemaw County, Michigan",1964,1671,26,1372,273,293
1400000US26163577900,"Census Tract 5779, Wayne County, Michigan",1617,1303,0,1137,166,314
1400000US26163578500,"Census Tract 5785, Wayne County, Michigan",1698,1414,9,1297,108,284
1400000US26163579100,"Census Tract 5791, Wayne County, Michigan",763,543,0,341,202,220
1400000US26163580400,"Census Tract 5804, Wayne County, Michigan",1155,978,8,870,100,177
1400000US26163579200,"Census Tract 5792, Wayne County, Michigan",1160,915,0,713,202,245
1400000US26163579800,"Census Tract 5798, Wayne County, Michigan",624,497,0,402,95,127
1400000US26163580300,"Census Tract 5803, Wayne County, Michigan",1170,1003,35,808,160,167
1400000US26163580600,"Census Tract 5806, Wayne County, Michigan",1234,1144,0,999,145,90
1400000US26163581200,"Census Tract 5812, Wayne County, Michigan",1710,1277,0,1223,54,433
1400000US26163521800,"Census Tract 5218, Wayne County, Michigan",938,615,0,426,189,323
1400000US26163520800,"Census Tract 5208, Wayne County, Michigan",1270,1242,0,1156,86,28
1400000US26163523400,"Census Tract 5234, Wayne County, Michigan",939,680,0,407,273,259
1400000US26163524500,"Census Tract 5245, Wayne County, Michigan",56,40,0,24,16,16
1400000US26163504200,"Census Tract 5042, Wayne County, Michigan",569,470,0,382,88,99
1400000US26163501400,"Census Tract 5014, Wayne County, Michigan",1276,1076,0,784,292,200
1400000US26163539400,"Census Tract 5394, Wayne County, Michigan",1371,1232,0,841,391,139
1400000US26163540200,"Census Tract 5402, Wayne County, Michigan",1154,997,0,576,421,157
1400000US26163541100,"Census Tract 5411, Wayne County, Michigan",970,623,0,348,275,347
1400000US26163541200,"Census Tract 5412, Wayne County, Michigan",946,764,0,540,224,182
1400000US26163543100,"Census Tract 5431, Wayne County, Michigan",943,848,0,750,98,95
1400000US26163543700,"Census Tract 5437, Wayne County, Michigan",833,648,0,466,182,185
1400000US26163546100,"Census Tract 5461, Wayne County, Michigan",1279,1102,0,674,428,177
1400000US26163550100,"Census Tract 5501, Wayne County, Michigan",1490,1379,0,1276,103,111
1400000US26163550800,"Census Tract 5508, Wayne County, Michigan",604,569,0,541,28,35
1400000US26163551100,"Census Tract 5511, Wayne County, Michigan",1856,1721,24,1586,111,135
1400000US26163554500,"Census Tract 5545, Wayne County, Michigan",1056,905,8,766,131,151
1400000US26163555600,"Census Tract 5556, Wayne County, Michigan",1081,927,9,805,113,154
1400000US26163559000,"Census Tract 5590, Wayne County, Michigan",977,943,0,928,15,34
1400000US26163562900,"Census Tract 5629, Wayne County, Michigan",1547,1484,9,1346,129,63
1400000US26163563600,"Census Tract 5636, Wayne County, Michigan",735,722,0,702,20,13
1400000US26163564100,"Census Tract 5641, Wayne County, Michigan",1750,1699,0,1603,96,51
1400000US26163569800,"Census Tract 5698, Wayne County, Michigan",941,845,0,714,131,96
1400000US26163565900,"Census Tract 5659, Wayne County, Michigan",1070,938,0,795,143,132
1400000US26163568300,"Census Tract 5683, Wayne County, Michigan",1742,1536,0,1391,145,206
1400000US26163568700,"Census Tract 5687, Wayne County, Michigan",1268,1178,0,1117,61,90
1400000US26163570500,"Census Tract 5705, Wayne County, Michigan",1268,1022,7,773,242,246
1400000US26163572000,"Census Tract 5720, Wayne County, Michigan",659,560,0,523,37,99
1400000US26163573400,"Census Tract 5734, Wayne County, Michigan",1008,798,12,670,116,210
1400000US26163577500,"Census Tract 5775, Wayne County, Michigan",1157,1024,11,783,230,133
1400000US26163583500,"Census Tract 5835, Wayne County, Michigan",1020,862,28,748,86,158
1400000US26163585500,"Census Tract 5855, Wayne County, Michigan",721,589,27,421,141,132
1400000US26163585800,"Census Tract 5858, Wayne County, Michigan",1551,1457,0,1097,360,94
1400000US26163588000,"Census Tract 5880, Wayne County, Michigan",2647,2566,16,2260,290,81
1400000US26163590600,"Census Tract 5906, Wayne County, Michigan",904,827,11,747,69,77
1400000US26163556400,"Census Tract 5564, Wayne County, Michigan",1701,1649,24,1537,88,52
1400000US26163558200,"Census Tract 5582, Wayne County, Michigan",1657,1452,33,1357,62,205
1400000US26163538100,"Census Tract 5381, Wayne County, Michigan",1010,925,0,836,89,85
1400000US26163570900,"Census Tract 5709, Wayne County, Michigan",818,710,0,492,218,108
1400000US26163575400,"Census Tract 5754, Wayne County, Michigan",1270,1144,21,994,129,126
1400000US26139021603,"Census Tract 216.03, Ottawa County, Michigan",1839,1713,0,1571,142,126
1400000US26163579700,"Census Tract 5797, Wayne County, Michigan",1218,806,11,695,100,412
1400000US26163584600,"Census Tract 5846, Wayne County, Michigan",776,644,9,466,169,132
1400000US26163554200,"Census Tract 5542, Wayne County, Michigan",1236,1138,21,962,155,98
1400000US26139021604,"Census Tract 216.04, Ottawa County, Michigan",2405,2313,0,2157,156,92
1400000US26139022900,"Census Tract 229, Ottawa County, Michigan",2171,2045,0,1865,180,126
1400000US26139023200,"Census Tract 232, Ottawa County, Michigan",916,795,5,673,117,121
1400000US26139020900,"Census Tract 209, Ottawa County, Michigan",1929,1691,7,1575,109,238
1400000US26139021700,"Census Tract 217, Ottawa County, Michigan",1571,1514,0,1450,64,57
1400000US26139022600,"Census Tract 226, Ottawa County, Michigan",820,786,6,766,14,34
1400000US26139020100,"Census Tract 201, Ottawa County, Michigan",1861,1638,46,1401,191,223
1400000US26139023100,"Census Tract 231, Ottawa County, Michigan",3905,3793,13,3511,269,112
1400000US26139020200,"Census Tract 202, Ottawa County, Michigan",1617,1388,34,1205,149,229
1400000US26139020600,"Census Tract 206, Ottawa County, Michigan",1442,1309,0,1222,87,133
1400000US26139021500,"Census Tract 215, Ottawa County, Michigan",3411,3118,18,2908,192,293
1400000US26139020400,"Census Tract 204, Ottawa County, Michigan",1679,1507,17,1302,188,172
1400000US26139021000,"Census Tract 210, Ottawa County, Michigan",2369,2038,15,1919,104,331
1400000US26139021100,"Census Tract 211, Ottawa County, Michigan",1957,1756,9,1642,105,201
1400000US26139021400,"Census Tract 214, Ottawa County, Michigan",2933,2658,36,2398,224,275
1400000US26065000800,"Census Tract 8, Ingham County, Michigan",1094,932,3,770,159,162
1400000US26065002700,"Census Tract 27, Ingham County, Michigan",1330,1204,0,1086,118,126
1400000US26061990100,"Census Tract 9901, Houghton County, Michigan",0,0,0,0,0,0
1400000US26077002601,"Census Tract 26.01, Kalamazoo County, Michigan",2063,1902,36,1766,100,161
1400000US26077001503,"Census Tract 15.03, Kalamazoo County, Michigan",1976,1885,0,1810,75,91
1400000US26077002101,"Census Tract 21.01, Kalamazoo County, Michigan",2915,2745,0,2647,98,170
1400000US26077002202,"Census Tract 22.02, Kalamazoo County, Michigan",3616,3391,0,3209,182,225
1400000US26077003400,"Census Tract 34, Kalamazoo County, Michigan",1482,1323,15,1162,146,159
1400000US26077000100,"Census Tract 1, Kalamazoo County, Michigan",892,755,0,687,68,137
1400000US26077001803,"Census Tract 18.03, Kalamazoo County, Michigan",764,664,0,600,64,100
1400000US26077001501,"Census Tract 15.01, Kalamazoo County, Michigan",1671,1457,0,1394,63,214
1400000US26077002102,"Census Tract 21.02, Kalamazoo County, Michigan",1126,1037,0,1015,22,89
1400000US26107960900,"Census Tract 9609, Mecosta County, Michigan",1332,1119,6,1009,104,213
1400000US26107960300,"Census Tract 9603, Mecosta County, Michigan",1126,953,14,821,118,173
1400000US26107960700,"Census Tract 9607, Mecosta County, Michigan",2356,2113,5,1754,354,243
1400000US26107960600,"Census Tract 9606, Mecosta County, Michigan",1303,1220,0,1065,155,83
1400000US26107960800,"Census Tract 9608, Mecosta County, Michigan",1685,1384,5,1153,226,301
1400000US26107960500,"Census Tract 9605, Mecosta County, Michigan",1779,1505,47,1237,221,274
1400000US26107960100,"Census Tract 9601, Mecosta County, Michigan",974,770,14,608,148,204
1400000US26107960200,"Census Tract 9602, Mecosta County, Michigan",1105,913,22,815,76,192
1400000US26107960400,"Census Tract 9604, Mecosta County, Michigan",1813,1592,42,1356,194,221
1400000US26107961000,"Census Tract 9610, Mecosta County, Michigan",2382,1977,25,1648,304,405
1400000US26103000500,"Census Tract 5, Marquette County, Michigan",107,102,0,47,55,5
1400000US26103002600,"Census Tract 26, Marquette County, Michigan",922,787,4,685,98,135
1400000US26103000100,"Census Tract 1, Marquette County, Michigan",885,783,0,700,83,102
1400000US26103001700,"Census Tract 17, Marquette County, Michigan",949,769,0,679,90,180
1400000US26103000700,"Census Tract 7, Marquette County, Michigan",1576,1315,9,997,309,261
1400000US26103000300,"Census Tract 3, Marquette County, Michigan",870,693,0,576,117,177
1400000US26103001200,"Census Tract 12, Marquette County, Michigan",2240,2014,22,1750,242,226
1400000US26103002400,"Census Tract 24, Marquette County, Michigan",1067,917,6,767,144,150
1400000US26103000200,"Census Tract 2, Marquette County, Michigan",934,870,0,762,108,64
1400000US26103002300,"Census Tract 23, Marquette County, Michigan",959,753,3,654,96,206
1400000US26103001500,"Census Tract 15, Marquette County, Michigan",1034,998,9,936,53,36
1400000US26103001800,"Census Tract 18, Marquette County, Michigan",1225,1102,10,1002,90,123
1400000US26103002100,"Census Tract 21, Marquette County, Michigan",1236,1026,0,977,49,210
1400000US26063951000,"Census Tract 9510, Huron County, Michigan",1615,1238,16,1044,178,377
1400000US26063950900,"Census Tract 9509, Huron County, Michigan",1511,1223,3,986,234,288
1400000US26063950400,"Census Tract 9504, Huron County, Michigan",443,373,3,348,22,70
1400000US26065000700,"Census Tract 7, Ingham County, Michigan",865,750,0,570,180,115
1400000US26081011401,"Census Tract 114.01, Kent County, Michigan",838,762,18,704,40,76
1400000US26081011600,"Census Tract 116, Kent County, Michigan",2807,2596,8,2379,209,211
1400000US26081001102,"Census Tract 11.02, Kent County, Michigan",1906,1663,0,1466,197,243
1400000US26081001200,"Census Tract 12, Kent County, Michigan",1452,1312,0,1206,106,140
1400000US26081002100,"Census Tract 21, Kent County, Michigan",1948,1706,0,1427,279,242
1400000US26081002500,"Census Tract 25, Kent County, Michigan",2141,2010,0,1903,107,131
1400000US26081002700,"Census Tract 27, Kent County, Michigan",1182,1085,0,1010,75,97
1400000US26145012400,"Census Tract 124, Saginaw County, Michigan",750,656,13,578,65,94
1400000US26145012600,"Census Tract 126, Saginaw County, Michigan",1416,1132,9,1028,95,284
1400000US26145013100,"Census Tract 131, Saginaw County, Michigan",2436,2154,12,1997,145,282
1400000US26145010600,"Census Tract 106, Saginaw County, Michigan",1108,859,0,784,75,249
1400000US26145010700,"Census Tract 107, Saginaw County, Michigan",2277,1911,27,1796,88,366
1400000US26145011100,"Census Tract 111, Saginaw County, Michigan",714,630,7,564,59,84
1400000US26145011701,"Census Tract 117.01, Saginaw County, Michigan",700,591,0,539,52,109
1400000US26145012300,"Census Tract 123, Saginaw County, Michigan",1161,965,8,818,139,196
1400000US26145012500,"Census Tract 125, Saginaw County, Michigan",1566,1208,22,1029,157,358
1400000US26145012700,"Census Tract 127, Saginaw County, Michigan",1839,1575,0,1445,130,264
1400000US26145001300,"Census Tract 13, Saginaw County, Michigan",982,789,0,659,130,193
1400000US26145011902,"Census Tract 119.02, Saginaw County, Michigan",898,787,0,723,64,111
1400000US26145012900,"Census Tract 129, Saginaw County, Michigan",1732,1520,45,1349,126,212
1400000US26145000600,"Census Tract 6, Saginaw County, Michigan",648,447,0,367,80,201
1400000US26145001200,"Census Tract 12, Saginaw County, Michigan",1211,985,15,856,114,226
1400000US26145001000,"Census Tract 10, Saginaw County, Michigan",1585,1067,0,742,325,518
1400000US26145001400,"Census Tract 14, Saginaw County, Michigan",1200,1055,10,964,81,145
1400000US26145010403,"Census Tract 104.03, Saginaw County, Michigan",2570,2260,0,2176,84,310
1400000US26145010501,"Census Tract 105.01, Saginaw County, Michigan",997,835,8,794,33,162
1400000US26145001700,"Census Tract 17, Saginaw County, Michigan",879,619,8,515,96,260
1400000US26145010402,"Census Tract 104.02, Saginaw County, Michigan",2456,2127,0,2041,86,329
1400000US26145012100,"Census Tract 121, Saginaw County, Michigan",1621,1342,19,1236,87,279
1400000US26145001600,"Census Tract 16, Saginaw County, Michigan",1457,1129,0,946,183,328
1400000US26145011200,"Census Tract 112, Saginaw County, Michigan",733,646,0,581,65,87
1400000US26155030700,"Census Tract 307, Shiawassee County, Michigan",1207,1042,0,946,96,165
1400000US26155030800,"Census Tract 308, Shiawassee County, Michigan",1227,1030,26,897,107,197
1400000US26155031500,"Census Tract 315, Shiawassee County, Michigan",2400,2252,26,2016,210,148
1400000US26155030100,"Census Tract 301, Shiawassee County, Michigan",2292,1923,23,1699,201,369
1400000US26155030600,"Census Tract 306, Shiawassee County, Michigan",754,643,0,576,67,111
1400000US26155031800,"Census Tract 318, Shiawassee County, Michigan",1741,1426,0,1341,85,315
1400000US26155030400,"Census Tract 304, Shiawassee County, Michigan",1212,1082,0,989,93,130
1400000US26155031700,"Census Tract 317, Shiawassee County, Michigan",1677,1376,0,1241,135,301
1400000US26155031402,"Census Tract 314.02, Shiawassee County, Michigan",1461,1374,16,1256,102,87
1400000US26155030300,"Census Tract 303, Shiawassee County, Michigan",2114,1786,16,1520,250,328
1400000US26155030200,"Census Tract 302, Shiawassee County, Michigan",1406,1217,17,1061,139,189
1400000US26155031401,"Census Tract 314.01, Shiawassee County, Michigan",2371,2096,37,1894,165,275
1400000US26155031600,"Census Tract 316, Shiawassee County, Michigan",1591,1392,0,1212,180,199
1400000US26155030500,"Census Tract 305, Shiawassee County, Michigan",1444,1232,0,1005,227,212
1400000US26081003400,"Census Tract 34, Kent County, Michigan",2260,1973,0,1897,76,287
1400000US26081004100,"Census Tract 41, Kent County, Michigan",1781,1671,0,1525,146,110
1400000US26081010200,"Census Tract 102, Kent County, Michigan",1560,1388,0,1194,194,172
1400000US26081010301,"Census Tract 103.01, Kent County, Michigan",1752,1489,9,1285,195,263
1400000US26163516100,"Census Tract 5161, Wayne County, Michigan",249,143,0,121,22,106
1400000US26163516800,"Census Tract 5168, Wayne County, Michigan",290,196,0,130,66,94
1400000US26163520200,"Census Tract 5202, Wayne County, Michigan",1016,897,0,758,139,119
1400000US26163520300,"Census Tract 5203, Wayne County, Michigan",1173,1025,0,972,53,148
1400000US26163522000,"Census Tract 5220, Wayne County, Michigan",900,669,0,542,127,231
1400000US26163522300,"Census Tract 5223, Wayne County, Michigan",725,384,0,205,179,341
1400000US26163523300,"Census Tract 5233, Wayne County, Michigan",969,767,0,522,245,202
1400000US26163550500,"Census Tract 5505, Wayne County, Michigan",1397,1306,7,1284,15,91
1400000US26163543900,"Census Tract 5439, Wayne County, Michigan",416,343,0,282,61,73
1400000US26163546500,"Census Tract 5465, Wayne County, Michigan",974,773,0,589,184,201
1400000US26163550300,"Census Tract 5503, Wayne County, Michigan",1182,1158,10,1142,6,24
1400000US26163551300,"Census Tract 5513, Wayne County, Michigan",1709,1448,0,1348,100,261
1400000US26163552100,"Census Tract 5521, Wayne County, Michigan",1309,1008,23,686,299,301
1400000US26125150900,"Census Tract 1509, Oakland County, Michigan",1609,1525,0,1416,109,84
1400000US26125159000,"Census Tract 1590, Oakland County, Michigan",1644,1533,5,1471,57,111
1400000US26059050400,"Census Tract 504, Hillsdale County, Michigan",1740,1382,25,1230,127,358
1400000US26059050800,"Census Tract 508, Hillsdale County, Michigan",833,668,0,651,17,165
1400000US26099233000,"Census Tract 2330, Macomb County, Michigan",2129,2058,0,1983,75,71
1400000US26099240700,"Census Tract 2407, Macomb County, Michigan",1589,1443,0,1374,69,146
1400000US26099240800,"Census Tract 2408, Macomb County, Michigan",2704,2325,0,2145,180,379
1400000US26099241800,"Census Tract 2418, Macomb County, Michigan",2110,1923,0,1672,251,187
1400000US26099243000,"Census Tract 2430, Macomb County, Michigan",1771,1660,0,1629,31,111
1400000US26099243500,"Census Tract 2435, Macomb County, Michigan",3062,2936,0,2618,318,126
1400000US26099250500,"Census Tract 2505, Macomb County, Michigan",930,864,7,806,51,66
1400000US26099215500,"Census Tract 2155, Macomb County, Michigan",2890,2593,0,2465,128,297
1400000US26099223800,"Census Tract 2238, Macomb County, Michigan",4619,4440,0,4156,284,179
1400000US26099226700,"Census Tract 2267, Macomb County, Michigan",2187,1880,0,1705,175,307
1400000US26099230200,"Census Tract 2302, Macomb County, Michigan",1889,1773,0,1748,25,116
1400000US26099230300,"Census Tract 2303, Macomb County, Michigan",1667,1547,0,1438,109,120
1400000US26099231100,"Census Tract 2311, Macomb County, Michigan",1629,1413,10,1330,73,216
1400000US26099232000,"Census Tract 2320, Macomb County, Michigan",741,657,0,620,37,84
1400000US26099232500,"Census Tract 2325, Macomb County, Michigan",1523,1475,0,1467,8,48
1400000US26099251200,"Census Tract 2512, Macomb County, Michigan",1373,1207,6,1079,122,166
1400000US26099247500,"Census Tract 2475, Macomb County, Michigan",958,771,0,714,57,187
1400000US26099250000,"Census Tract 2500, Macomb County, Michigan",953,851,0,817,34,102
1400000US26099251100,"Census Tract 2511, Macomb County, Michigan",867,766,4,703,59,101
1400000US26099255000,"Census Tract 2550, Macomb County, Michigan",2040,1761,0,1474,287,279
1400000US26099255700,"Census Tract 2557, Macomb County, Michigan",712,613,5,532,76,99
1400000US26099256600,"Census Tract 2566, Macomb County, Michigan",1380,1055,0,869,186,325
1400000US26099258400,"Census Tract 2584, Macomb County, Michigan",1988,1752,0,1398,354,236
1400000US26099261700,"Census Tract 2617, Macomb County, Michigan",1139,953,0,880,73,186
1400000US26099261900,"Census Tract 2619, Macomb County, Michigan",1269,1057,0,988,69,212
1400000US26099262100,"Census Tract 2621, Macomb County, Michigan",423,345,6,299,40,78
1400000US26099262600,"Census Tract 2626, Macomb County, Michigan",1043,777,8,725,44,266
1400000US26099262900,"Census Tract 2629, Macomb County, Michigan",1529,1277,0,1154,123,252
1400000US26099212000,"Census Tract 2120, Macomb County, Michigan",2021,1808,0,1718,90,213
